toxic-rest-0	把这帮小自贤孙虫报	把这帮孝子贤孙冲爆	[(4, '孝'), (5, '子'), (8, '冲'), (9, '爆')]
toxic-rest-1	变她ma了个🐔8，拒绝天够从我做起	变她ma了个🐔8，拒绝舔狗从我做起	[(12, '舔'), (13, '狗')]
toxic-rest-2	我们小区也有个金发碧眼的小萝莉 家长们都挺喜欢的 因为真的长的超级可爱 活像洋娃娃 而且人家父母都是高知分子 但是对那个没爹的混血校嗨态度就不一样了😅	我们小区也有个金发碧眼的小萝莉 家长们都挺喜欢的 因为真的长的超级可爱 活像洋娃娃 而且人家父母都是高知分子 但是对那个没爹的混血小黑态度就不一样了😅	[(66, '小'), (67, '黑')]
toxic-rest-3	就算你反对了那么个法案，现实总会给你一些更致命的新发现元来这个法案只是结果，不是元因	就算你反对了那么个法案，现实总会给你一些更致命的新发现原来这个法案只是结果，不是原因	[(28, '原'), (41, '原')]
toxic-rest-4	确实现在的全是天生就是坏种它们贪婪傲慢懒惰暴食淫欲嫉妒暴怒七宗罪它们全部都犯了它们欲壑难填利令智昏是出胜不如的东西	确实现在的拳师天生就是坏种它们贪婪傲慢懒惰暴食淫欲嫉妒暴怒七宗罪它们全部都犯了它们欲壑难填利令智昏是畜生不如的东西	[(6, '拳'), (7, '师'), (51, '畜'), (52, '生')]
toxic-rest-5	其实我倒是对黑人和白人没啥感觉，但我绝对不会娶。首先和黑人之类的外国人在一起肯定会有很大的外在压力，但这些压力都顶住了，付出了那么多后为什么还会分手呢？1.真心相爱，性格不合？但早干嘛去了，非要滚过床单才这么想。2.接受不了黑人的习俗？黑人的习俗比之前承受的压力都可怕？那我更不能理解最初为什么要选黑人了。这些不应该在滚床单之前就做好调查的么？3.尝试一下黑人的滋味？这更可怕，放荡不羁爱自由？那相亲对象知晓详情紧急避险不是理所当然的么。4.被诱惑？钱？身份？还是可以在朋友圈炫耀外国男友，鹤立及群的优越感？发现黑人不能够满足需求果断分手，寻找下家。我知道我可能将这些女性看的过于阴暗。但我还是会这么想。这样的结婚对象你会要吗？反正我不会。	其实我倒是对黑人和白人没啥感觉，但我绝对不会娶。首先和黑人之类的外国人在一起肯定会有很大的外在压力，但这些压力都顶住了，付出了那么多后为什么还会分手呢？1.真心相爱，性格不合？但早干嘛去了，非要滚过床单才这么想。2.接受不了黑人的习俗？黑人的习俗比之前承受的压力都可怕？那我更不能理解最初为什么要选黑人了。这些不应该在滚床单之前就做好调查的么？3.尝试一下黑人的滋味？这更可怕，放荡不羁爱自由？那相亲对象知晓详情紧急避险不是理所当然的么。4.被诱惑？钱？身份？还是可以在朋友圈炫耀外国男友，鹤立鸡群的优越感？发现黑人不能够满足需求果断分手，寻找下家。我知道我可能将这些女性看的过于阴暗。但我还是会这么想。这样的结婚对象你会要吗？反正我不会。	[(248, '鸡')]
toxic-rest-6	希望早日实施黑去清楚计划	希望早日实施黑蛆清楚计划	[(8, '蛆')]
toxic-rest-7	看我直接化身贴吧暴躁老哥，直接喷死双表男	看我直接化身贴吧暴躁老哥，直接喷死双标男	[(19, '标')]
toxic-rest-8	都是境外分裂势力搞的鬼，你想想，西南的西藏，西北的新疆，再把东北和中元闹的人心不合，中国还剩啥了？一些不明就里的傻蛋还跟着起哄，还有某些东南假洋贵自媒体带节奏，没有媒体带节奏怎么能形成气候？就像游行也好，抵制也好，没有带头的怎么能发动起来？愚民到啥时候都是愚民👍️👍️👍️	都是境外分裂势力搞的鬼，你想想，西南的西藏，西北的新疆，再把东北和中原闹的人心不合，中国还剩啥了？一些不明就里的傻蛋还跟着起哄，还有某些东南假洋鬼子媒体带节奏，没有媒体带节奏怎么能形成气候？就像游行也好，抵制也好，没有带头的怎么能发动起来？愚民到啥时候都是愚民👍️👍️👍️	[(35, '原'), (73, '鬼'), (74, '子')]
toxic-rest-9	其实没必要歧视，只要跟黑难换国籍就行了	其实没必要歧视，只要跟黑男换国籍就行了	[(13, '男')]
toxic-rest-10	其实韩国人。。。娘抛。。。😄😄😄	其实韩国人。。。娘炮。。。😄😄😄	[(10, '炮')]
toxic-rest-11	救命，好恶讯惹	救命，好恶熏惹	[(6, '熏')]
toxic-rest-12	我国那么多老艺术家离世的时候尼小自们也没这么悲伤过	我国那么多老艺术家离世的时候尼孝子们也没这么悲伤过	[(16, '孝'), (17, '子')]
toxic-rest-13	跟犯罪率没有必然关系，跟历史，语言，文化元因有很大关系。地域冲突本质上是男人间的冲突，安徽男人相当一部分是哪怕外表客气，内心里还是相当自大的，老子天下第一，即便兜里没钱。至于你在另一个回答里面说安徽男人性格软，说明你根本不了解身边的安徽男人，当年在天涯上海，一群安徽人要打著名上海碰字“趴趴鸭”。可以说，历史上欺负江浙沪最多的就是安徽人。除了我之前列举的那些，还有明朝时淮西集团对浙东集团的打压。为什么明朝时东林党最后只顾党争不顾国家，因为他们基本上都是苏南浙江官员，鼎鼎大名的钱谦益就是代表。江浙沪三地，真正优秀的是浙江人，安徽人与浙江人合作容易成事:比如周瑜与孙权，朱元璋与刘伯温。浙江人兼具才华，胸怀，城府，隐忍等诸多品质。江苏人跟浙江人比，缺少胸怀与城府，心里藏不住事，啥都表现在外表，得罪人最多。至于传统意义上的上海人，在上海将会越来越边缘化，上海滩真正牛逼的是浙江人。	跟犯罪率没有必然关系，跟历史，语言，文化原因有很大关系。地域冲突本质上是男人间的冲突，安徽男人相当一部分是哪怕外表客气，内心里还是相当自大的，老子天下第一，即便兜里没钱。至于你在另一个回答里面说安徽男人性格软，说明你根本不了解身边的安徽男人，当年在天涯上海，一群安徽人要打著名上海喷子“趴趴鸭”。可以说，历史上欺负江浙沪最多的就是安徽人。除了我之前列举的那些，还有明朝时淮西集团对浙东集团的打压。为什么明朝时东林党最后只顾党争不顾国家，因为他们基本上都是苏南浙江官员，鼎鼎大名的钱谦益就是代表。江浙沪三地，真正优秀的是浙江人，安徽人与浙江人合作容易成事:比如周瑜与孙权，朱元璋与刘伯温。浙江人兼具才华，胸怀，城府，隐忍等诸多品质。江苏人跟浙江人比，缺少胸怀与城府，心里藏不住事，啥都表现在外表，得罪人最多。至于传统意义上的上海人，在上海将会越来越边缘化，上海滩真正牛逼的是浙江人。	[(21, '原'), (141, '喷'), (142, '子')]
toxic-rest-14	不要看到几个就觉得霉黑很严重，反正我见不少黑人，只看到一个体重两百斤的没黑女和黑人在一起	不要看到几个就觉得霉黑很严重，反正我见不少黑人，只看到一个体重两百斤的没黑女和黑人在一起	[]
toxic-rest-15	绝对不可能，当然避免被喷，我觉得在讨论接受与黑人处过的女孩前，先问清楚她为毛非得和黑人处，以及后来处不了分手的元因。	绝对不可能，当然避免被喷，我觉得在讨论接受与黑人处过的女孩前，先问清楚她为毛非得和黑人处，以及后来处不了分手的原因。	[(56, '原')]
toxic-rest-16	大多是被后天教育出的利女男，以为能用舔和服从换来爱情此内人是优良的供养者	大多是被后天教育出的利女男，以为能用舔和服从换来爱情此类人是优良的供养者	[(28, '类')]
toxic-rest-17	1孩子都是女人生的，为什么多几千万，你们女人最清楚。2.我没看懂。3.为什么不是双表？女人和男人不一样。你的女儿被别人玩了，和你的儿子玩了别人能一样吗？等你有儿女了你就明白了。再说了在民族利益面前，双表算什么？美国为了自己的利益，不是每天都双表吗？而且美国照样世界第一。不双表有可能是没有能力双表而已，并不是因为道德感。4.有什么不敢承认的，人口本来就是资源，为什么要让给外国人，这些外国人拿着中国补贴，打着中国疫苗，玩着中国女人，嘴里说着我爱中国，转过头就在外网上曝光easy girl 并配上污秽不堪的文字羞辱中国人。外国人墙件中国女人的新闻有多少被压下去了？新闻爆出来的只是冰山一角。未完	1孩子都是女人生的，为什么多几千万，你们女人最清楚。2.我没看懂。3.为什么不是双标？女人和男人不一样。你的女儿被别人玩了，和你的儿子玩了别人能一样吗？等你有儿女了你就明白了。再说了在民族利益面前，双标算什么？美国为了自己的利益，不是每天都双标吗？而且美国照样世界第一。不双标有可能是没有能力双标而已，并不是因为道德感。4.有什么不敢承认的，人口本来就是资源，为什么要让给外国人，这些外国人拿着中国补贴，打着中国疫苗，玩着中国女人，嘴里说着我爱中国，转过头就在外网上曝光easy girl 并配上污秽不堪的文字羞辱中国人。外国人强奸中国女人的新闻有多少被压下去了？新闻爆出来的只是冰山一角。未完	[(42, '标'), (101, '标'), (122, '标'), (138, '标'), (148, '标'), (265, '强'), (266, '奸')]
toxic-rest-18	这话说的，凭什么就允许别人在网上说自己喜欢吃四，不允许别人在网上说讨厌吃四了？	这话说的，凭什么就允许别人在网上说自己喜欢吃屎，不允许别人在网上说讨厌吃屎了？	[(23, '屎'), (37, '屎')]
toxic-rest-19	而更多对同性恋抱有偏见的人他们偏见的方式是通过侮辱诅咒同性恋，通过散播自己本就不健全的三观，用各种伪科学或者哲学观点来证明同性恋的劣等和同性恋不该存在在世界上的扭曲便太思想，这种人还挺多的。如果有人告诉他他的这个想法是错的，他就会好像一个被爸爸妈妈惯坏的孩子，在受到社会的毒打后通过发狂和哭泣的方式伤害对他造成心理“伤害”的来源。但你不一样，你对txl除了不伤害，也给自己推倒之前偏见的机会，这还挺好的，这点连很多同性恋自己都做不到。	而更多对同性恋抱有偏见的人他们偏见的方式是通过侮辱诅咒同性恋，通过散播自己本就不健全的三观，用各种伪科学或者哲学观点来证明同性恋的劣等和同性恋不该存在在世界上的扭曲变态思想，这种人还挺多的。如果有人告诉他他的这个想法是错的，他就会好像一个被爸爸妈妈惯坏的孩子，在受到社会的毒打后通过发狂和哭泣的方式伤害对他造成心理“伤害”的来源。但你不一样，你对txl除了不伤害，也给自己推倒之前偏见的机会，这还挺好的，这点连很多同性恋自己都做不到。	[(83, '变'), (84, '态')]
toxic-rest-20	道德绑架够溜 你没有反对我们不喜欢同性恋的权利 正如你没有反对地球是圆的权利 这些必须就这样 不然你就是霜表	道德绑架够溜 你没有反对我们不喜欢同性恋的权利 正如你没有反对地球是圆的权利 这些必须就这样 不然你就是双标	[(53, '双'), (54, '标')]
toxic-rest-21	天勾的自我修养，女全越是猖獗他们越觉得应该抓紧舔，自己卷自己了属于是	舔狗的自我修养，女拳越是猖獗他们越觉得应该抓紧舔，自己卷自己了属于是	[(1, '舔'), (2, '狗'), (10, '拳')]
toxic-rest-22	反绿券是因为：他们并非善类，绞尽脑汁把广大女性作为工具，来发泄他们对夫权和父权的仇恨。（对女性也没有善意，一旦女性有不同观点不同价值观，也同样会被他们攻击辱骂）	反女拳是因为：他们并非善类，绞尽脑汁把广大女性作为工具，来发泄他们对夫权和父权的仇恨。（对女性也没有善意，一旦女性有不同观点不同价值观，也同样会被他们攻击辱骂）	[(2, '女'), (3, '拳')]
toxic-rest-23	能把这小里个掐死吗	能把这小倪格掐死吗	[(5, '倪'), (6, '格')]
toxic-rest-24	同性恋总是爱跟异性恋比较，认为自己做的错事别人也会做所以把自己做的错事合理化，只会不断错下去乱下去。连让艾染病后也觉得跟异性恋差不多。同性恋不会正视自己跟异性恋生活上的不同之处，只会看异性恋的缺点不会看异性恋的优点	同性恋总是爱跟异性恋比较，认为自己做的错事别人也会做所以把自己做的错事合理化，只会不断错下去乱下去。连染艾染病后也觉得跟异性恋差不多。同性恋不会正视自己跟异性恋生活上的不同之处，只会看异性恋的缺点不会看异性恋的优点	[(52, '染')]
toxic-rest-25	吃着碗里的，看着锅里的，吃自己的那份还不够，还要到男人的饭碗里争食！据说，有一个女权主义者已经到相关部门去申请了?男人的饭碗的所有权?！不可思议~据说，那个部门叫：控制欲旺盛政客?理论羟间?他人知识库！	吃着碗里的，看着锅里的，吃自己的那份还不够，还要到男人的饭碗里争食！据说，有一个女权主义者已经到相关部门去申请了?男人的饭碗的所有权?！不可思议~据说，那个部门叫：控制欲旺盛政客?理论强奸?他人知识库！	[(93, '强'), (94, '奸')]
toxic-rest-26	关键她是维权😆以前都站消费者的南达人，突然觉得你一穷省找安啦上海银麻烦哦🙄	关键她是维权😆以前都站消费者的南大人，突然觉得你一穷省找安啦上海银麻烦哦🙄	[(17, '大')]
toxic-rest-27	人你不找，非得玩人与兽，不恶新吗	人你不找，非得玩人与兽，不恶心吗	[(15, '心')]
toxic-rest-28	从小投净該，攒钱卖羊肉串，来人问你这串保熟不？你拿着切糕的刀给他砍了。	从小偷井盖，攒钱卖羊肉串，来人问你这串保熟不？你拿着切糕的刀给他砍了。	[(3, '偷'), (4, '井'), (5, '盖')]
toxic-rest-29	房童的人寿命短可能因为做了同妻同夫自我了断但只是少数人会这样	反同的人寿命短可能因为做了同妻同夫自我了断但只是少数人会这样	[(1, '反'), (2, '同')]
toxic-rest-30	人和人当然平等，人和新型平等？	人和人当然平等，人和猩猩平等？	[(11, '猩'), (12, '猩')]
toxic-rest-31	没见过集闹工程师	没见过基佬工程师	[(4, '基'), (5, '佬')]
toxic-rest-32	普通女性占女性总人口的比例还是太少了，女全、媚外的的占了绝大多数🤣	普通女性占女性总人口的比例还是太少了，女拳、媚外的的占了绝大多数🤣	[(21, '拳')]
toxic-rest-33	而你晚上是被关购笼里所以无法发言对吧？毕竟是个吃软饭的能有个购笼住就不错了，不然你在每个凌晨的整点时间段回我一句呀	而你晚上是被关狗笼里所以无法发言对吧？毕竟是个吃软饭的能有个狗笼住就不错了，不然你在每个凌晨的整点时间段回我一句呀	[(8, '狗'), (31, '狗')]
toxic-rest-34	那些嫁给抹的国女能自愿放弃中国国籍，绝对值得立牌坊。	那些嫁给默的国女能自愿放弃中国国籍，绝对值得立牌坊。	[(5, '默')]
toxic-rest-35	我怀疑你在侮辱要借，即使要借接了还挣钱的呢，她们白给甚至倒贴🤔	我怀疑你在侮辱窑姐，即使窑姐接了还挣钱的呢，她们白给甚至倒贴🤔	[(8, '窑'), (9, '姐'), (13, '窑'), (14, '姐')]
toxic-rest-36	有一说一 人类进化就是靠砸中推进的 你圈起来养的那些个观赏动物才在意纯种 血统论的目的主要是为了给种族歧视创造合法性 虽然我是皇汉 但是不建议整这种活嗷	有一说一 人类进化就是靠杂种推进的 你圈起来养的那些个观赏动物才在意纯种 血统论的目的主要是为了给种族歧视创造合法性 虽然我是皇汉 但是不建议整这种活嗷	[(13, '杂'), (14, '种')]
toxic-rest-37	我说的是，笑先女她求分享，楼主不理她，她就开贴引战，还带了天够来。	我说的是，小藓女她求分享，楼主不理她，她就开贴引战，还带了舔狗来。	[(6, '小'), (7, '藓'), (30, '舔'), (31, '狗')]
toxic-rest-38	但是我们要“理解”级老，因为它们在现实生活中活得太憋屈了，它们之所以把别人先禁言了又去麻人，就很好的证明了这一点，它们需要发泄，但是又害怕看到那些回击它们的内容，所以只能如此	但是我们要“理解”基佬，因为它们在现实生活中活得太憋屈了，它们之所以把别人先禁言了又去麻人，就很好的证明了这一点，它们需要发泄，但是又害怕看到那些回击它们的内容，所以只能如此	[(10, '基'), (11, '佬')]
toxic-rest-39	后面改成魔也算人😅	后面改成默也算人😅	[(5, '默')]
toxic-rest-40	看来当同寻怒是他唯一的精神支柱了，怪不得如此顽抗。	看来当通讯录是他唯一的精神支柱了，怪不得如此顽抗。	[(4, '通'), (5, '讯'), (6, '录')]
toxic-rest-41	同性恋运动者将反对者统一称之为“控铜者”，然后又抛出“控铜都是深柜”的论调，试图对反对者进行阻吓。这其实是一种人身攻击的手段，因为同性恋运动的反对者，实在没有必要害怕同性恋者或者同性性偏好，有可能只是出于心理本能厌恶不正常的异类，称之为“厌同者”更为合适。将反对者塑造成“控铜者”，想要无中生有的强调其愚村、歇斯底里的特点，这不就是霸凌者嘲笑南酮性恋者娘娘腔或者心理便太的翻版吗？不同的是，同性恋者已经通过发明新词的方式，将这种歧视制度化了。同性恋者总是强调受到霸凌，但其自己何尝不是有组织的、公开的霸凌反对者？而污蔑别人是同性恋者，着实有点像小孩子抓了一把时硬要涂在对方身上。	同性恋运动者将反对者统一称之为“恐同者”，然后又抛出“恐同都是深柜”的论调，试图对反对者进行阻吓。这其实是一种人身攻击的手段，因为同性恋运动的反对者，实在没有必要害怕同性恋者或者同性性偏好，有可能只是出于心理本能厌恶不正常的异类，称之为“厌同者”更为合适。将反对者塑造成“恐同者”，想要无中生有的强调其愚蠢、歇斯底里的特点，这不就是霸凌者嘲笑男同性恋者娘娘腔或者心理变态的翻版吗？不同的是，同性恋者已经通过发明新词的方式，将这种歧视制度化了。同性恋者总是强调受到霸凌，但其自己何尝不是有组织的、公开的霸凌反对者？而污蔑别人是同性恋者，着实有点像小孩子抓了一把屎硬要涂在对方身上。	[(17, '恐'), (18, '同'), (28, '恐'), (29, '同'), (137, '恐'), (138, '同'), (153, '蠢'), (172, '男'), (173, '同'), (184, '变'), (185, '态'), (280, '屎')]
toxic-rest-42	这种男人也是极少数，像我这种只是单纯的脯新罢了🐶	这种男人也是极少数，像我这种只是单纯的普信罢了🐶	[(20, '普'), (21, '信')]
toxic-rest-43	选择器喽，那些找礼各的女人的智商水平，社会责任感和价值观显然不配和正常的国人哺育正常的后代😄可惜就是有人爱接盘😄	选择器喽，那些找泥搁的女人的智商水平，社会责任感和价值观显然不配和正常的国人哺育正常的后代😄可惜就是有人爱接盘😄	[(9, '泥'), (10, '搁')]
toxic-rest-44	但为什么在别的地方那个目人可以讲出来这些话？	但为什么在别的地方那个幕刃可以讲出来这些话？	[(12, '幕'), (13, '刃')]
toxic-rest-45	首先赞楼主，其次难通胞不接受这种女人我感觉不能说保守，任何国家的男人都不会接受别国男人在自己国家乱搞女人的！ 某些人混淆视听，说外国人更开放不在乎这些，那他去欧美乱搞一下试试就知道了	首先赞楼主，其次男同胞不接受这种女人我感觉不能说保守，任何国家的男人都不会接受别国男人在自己国家乱搞女人的！ 某些人混淆视听，说外国人更开放不在乎这些，那他去欧美乱搞一下试试就知道了	[(9, '男'), (10, '同')]
toxic-rest-46	我特烦一张嘴就这事不关你事的人，管天管地管的着别人怎么看？照你的理论，匹判这些人也不关你事啊？你废什么话？	我特烦一张嘴就这事不关你事的人，管天管地管的着别人怎么看？照你的理论，批判这些人也不关你事啊？你废什么话？	[(36, '批')]
toxic-rest-47	值得啤判！我不明白为什么人种没有生殖隔离呢？爱美之心人皆有之！一白遮百丑！美白，美白，美听说过美黑的。没见过黑人去选美的。	值得批判！我不明白为什么人种没有生殖隔离呢？爱美之心人皆有之！一白遮百丑！美白，美白，美听说过美黑的。没见过黑人去选美的。	[(3, '批')]
toxic-rest-48	在吾看来，非洲人要也好过非洲男人至少非洲人要不会随意侵犯女性	在吾看来，非洲人妖也好过非洲男人至少非洲人妖不会随意侵犯女性	[(9, '妖'), (22, '妖')]
toxic-rest-49	及汤的作者和读者都是女人，不向着女人她们没销量	鸡汤的作者和读者都是女人，不向着女人她们没销量	[(1, '鸡')]
toxic-rest-50	看了好多也不敢加，合肥南通事件当事人都没啥事	看了好多也不敢加，合肥男童事件当事人都没啥事	[(12, '男'), (13, '童')]
toxic-rest-51	拿着一张p的图在这里意淫，桶寻怒是不是都有臆想症。	拿着一张p的图在这里意淫，通讯录是不是都有臆想症。	[(14, '通'), (15, '讯'), (16, '录')]
toxic-rest-52	我算是看明白了这吧的脱尿，先抛出一个没头没尾的论证，等别人怼他的们时候，然后再打马后炮。这招真是屡试不爽啊！	我算是看明白了这吧的鸵鸟，先抛出一个没头没尾的论证，等别人怼他的们时候，然后再打马后炮。这招真是屡试不爽啊！	[(11, '鸵'), (12, '鸟')]
toxic-rest-53	黑人的天勾其实比黑人更可恨	黑人的舔狗其实比黑人更可恨	[(4, '舔'), (5, '狗')]
toxic-rest-54	你个能不能死?	倪哥能不能死?	[(1, '倪'), (2, '哥')]
toxic-rest-55	母沟是这样的	母狗是这样的	[(2, '狗')]
toxic-rest-56	大皮直男被邪恶的及劳勾引失足建议立即将他们绞杀！	大批直男被邪恶的基佬勾引失足建议立即将他们绞杀！	[(2, '批'), (9, '基'), (10, '佬')]
toxic-rest-57	值老的瓜真是太香了哦，吃不完了	直佬的瓜真是太香了哦，吃不完了	[(1, '直'), (2, '佬')]
toxic-rest-58	哈哈哈，小先率的事要你们管	哈哈哈，小仙女的事要你们管	[(6, '仙'), (7, '女')]
toxic-rest-59	是被阿拉夺舍了吗我寻思着就阿拉这个水平应该也学不会盗号啊	是被阿娜夺舍了吗我寻思着就阿娜这个水平应该也学不会盗号啊	[(4, '娜'), (15, '娜')]
toxic-rest-60	我已经累了，也懒得讲道理了，爱咋咋地吧，ez和模关我什么事啊，总有一天中国要整出个右翼分子	我已经累了，也懒得讲道理了，爱咋咋地吧，ez和默关我什么事啊，总有一天中国要整出个右翼分子	[(24, '默')]
toxic-rest-61	去黑飞走就行，那里有酋长	去黑非洲就行，那里有酋长	[(3, '非'), (4, '洲')]
toxic-rest-62	MB关键是有的gay他还嫂扰你，她吗的刚刚差点让一个gay亲了，再有下次老子打掉他满嘴牙，我这不是恶新，是唾弃	MB关键是有的gay他还骚扰你，他妈的刚刚差点让一个gay亲了，再有下次老子打掉他满嘴牙，我这不是恶心，是唾弃	[(13, '骚'), (17, '他'), (18, '妈'), (51, '心')]
toxic-rest-63	简单地说，“我”网络上可以重拳出击，一喷喷一片，现实里面友好相处，尊重女性，如果发现身边有谁酶嗨，那不好意思，一票否决	简单地说，“我”网络上可以重拳出击，一喷喷一片，现实里面友好相处，尊重女性，如果发现身边有谁媚黑，那不好意思，一票否决	[(47, '媚'), (48, '黑')]
toxic-rest-64	看了那么多回答，没看到因为说害怕艾滋，搞不懂，男人娶嗨女白女好像他们就没啥意见了，女人搞费各白男，他们反应好大，看不懂	看了那么多回答，没看到因为说害怕艾滋，搞不懂，男人娶黑女白女好像他们就没啥意见了，女人搞黑哥白男，他们反应好大，看不懂	[(27, '黑'), (45, '黑'), (46, '哥')]
toxic-rest-65	害怕？哈哈哈，你真以为大家是害怕？害怕娶不到媳妇儿？哎呀妈呀，合着你觉得男人匹判女人找黑人是害怕找不着媳妇儿？	害怕？哈哈哈，你真以为大家是害怕？害怕娶不到媳妇儿？哎呀妈呀，合着你觉得男人批判女人找黑人是害怕找不着媳妇儿？	[(39, '批')]
toxic-rest-66	为啥总有虾爬子一样的二及馆？正常化就正常化呗，非要跳出来表示同性恋就是高贵就是先进就是现代化吗？扯犊子	为啥总有虾爬子一样的二极管？正常化就正常化呗，非要跳出来表示同性恋就是高贵就是先进就是现代化吗？扯犊子	[(12, '极'), (13, '管')]
toxic-rest-67	没心气管了，上次外过人永居我尽力了	没心气管了，上次歪果人永居我尽力了	[(9, '歪'), (10, '果')]
toxic-rest-68	尼日利亚的名菜“乔洛夫”，油焖香米饭加上及腿和油炸香蕉。这道菜的米饭和手抓饭类似，都要加入洋葱和胡萝卜，也可用手抓着吃，微辣。	尼日利亚的名菜“乔洛夫”，油焖香米饭加上鸡腿和油炸香蕉。这道菜的米饭和手抓饭类似，都要加入洋葱和胡萝卜，也可用手抓着吃，微辣。	[(21, '鸡')]
toxic-rest-69	这就是个大筛子，筛掉那些沙指	这就是个大筛子，筛掉那些傻子	[(13, '傻'), (14, '子')]
toxic-rest-70	为什么必须反率犬	为什么必须反女拳	[(7, '女'), (8, '拳')]
toxic-rest-71	猿形毕露了兄弟们，大家理解一下，这只沟沟的YD长在了性性身上，大家要有怜悯之心，毕竟会说话的动物很难得的，大家每天拿它娱乐娱乐多好	猿形毕露了兄弟们，大家理解一下，这只狗狗的YD长在了猩猩身上，大家要有怜悯之心，毕竟会说话的动物很难得的，大家每天拿它娱乐娱乐多好	[(19, '狗'), (20, '狗'), (27, '猩'), (28, '猩')]
toxic-rest-72	汉弗莱:...甚至不能以帮至大四😜	汉弗莱:...甚至不能一棒子打死😜	[(12, '一'), (13, '棒'), (14, '子'), (15, '打'), (16, '死')]
toxic-rest-73	一个蓝火，有老公，有小孩，喝酒抽烟出轨，乱搞男女关系。开了私密模式，关了私信功能，私信不了，只能在视频评论区艾特她骂。	一个烂货，有老公，有小孩，喝酒抽烟出轨，乱搞男女关系。开了私密模式，关了私信功能，私信不了，只能在视频评论区艾特她骂。	[(3, '烂'), (4, '货')]
toxic-rest-74	知乎里的中国女人是不可以有优点的，真的是硬生生按着普通女人的头，让她们承认，反驳这个称号的说明知道羞耻心，不明白为什么一些男人一定要这样对自己同胞，要他们不要内讧，他们说这是洋人给的，一起认同洋拉及，可笑，自己喜欢外国女人就是为国争光，女人就是比男人多了贞洁感，在男人眼里睡女人还是被女人睡永远是赚了，挨骂的永远是女人	知乎里的中国女人是不可以有优点的，真的是硬生生按着普通女人的头，让她们承认，反驳这个称号的说明知道羞耻心，不明白为什么一些男人一定要这样对自己同胞，要他们不要内讧，他们说这是洋人给的，一起认同洋垃圾，可笑，自己喜欢外国女人就是为国争光，女人就是比男人多了贞洁感，在男人眼里睡女人还是被女人睡永远是赚了，挨骂的永远是女人	[(98, '垃'), (99, '圾')]
toxic-rest-75	如果我没记错的话这个楼足可是大名鼎鼎跪虫圣父标到今天发了一个冲内及其它们后代从浑增长录事实没有任何问题但是经过著名大名鼎鼎跪虫圣父标发出来就有点居心叵测毕竟古人言：事出反常必有妖！	如果我没记错的话这个楼猪可是大名鼎鼎跪虫圣父标到今天发了一个虫类及其它们后代虫混增长录事实没有任何问题但是经过著名大名鼎鼎跪虫圣父标发出来就有点居心叵测毕竟古人言：事出反常必有妖！	[(12, '猪'), (31, '虫'), (32, '类'), (39, '虫'), (40, '混')]
toxic-rest-76	对的它们国际轨自冲内及其它们后代充婚在全球就是老速耗子过街人人喊打	对的它们国际鬼子虫类及其它们后代虫混在全球就是老鼠耗子过街人人喊打	[(7, '鬼'), (8, '子'), (9, '虫'), (10, '类'), (17, '虫'), (18, '混'), (25, '鼠')]
toxic-rest-77	求个中外哲学家评论姆仍的图	求个中外哲学家评论幕刃的图	[(10, '幕'), (11, '刃')]
toxic-rest-78	我讨厌双表魅黑人，觉得男人娶黑人就光宗耀祖的那种	我讨厌双标魅黑人，觉得男人娶黑人就光宗耀祖的那种	[(5, '标')]
toxic-rest-79	根据我多年的实践，一般男凡痛有三种情况。第一，他身边的亲近之人是，这种现实让他无法接受，进而内心受创。第二，他自己因此尔受到过伤害，比如曾经被霸王硬上弓，或者曾经感情受创被打击过，再或者因此发生过不愉快的事。第三，我不知道怎么说才能过审，所以不说了。如果是第一种，大概率是患者的父亲或者兄弟再或者幼时比较亲近的男性。我之前在他的评论区试探过，说到患者父亲的时候，并没有什么奇怪的反应。但是我说到患者自身的时候，总是刻意忽视，不做回应。根据这种逃避现象，我初步诊断，是他自身的问题。所以我才这么说。（虽然我说的是另一个人，不知道是不是同一个人的小号。但是如果觉得有用，可以复制拿去发帖）	根据我多年的实践，一般男反同有三种情况。第一，他身边的亲近之人是，这种现实让他无法接受，进而内心受创。第二，他自己因此尔受到过伤害，比如曾经被霸王硬上弓，或者曾经感情受创被打击过，再或者因此发生过不愉快的事。第三，我不知道怎么说才能过审，所以不说了。如果是第一种，大概率是患者的父亲或者兄弟再或者幼时比较亲近的男性。我之前在他的评论区试探过，说到患者父亲的时候，并没有什么奇怪的反应。但是我说到患者自身的时候，总是刻意忽视，不做回应。根据这种逃避现象，我初步诊断，是他自身的问题。所以我才这么说。（虽然我说的是另一个人，不知道是不是同一个人的小号。但是如果觉得有用，可以复制拿去发帖）	[(13, '反'), (14, '同')]
toxic-rest-80	当然如果是爱出去乱约的，无论男女都非常的恶新	当然如果是爱出去乱约的，无论男女都非常的恶心	[(22, '心')]
toxic-rest-81	这么好的肤色竟然在美国做其该。来中国山东大学不得飞黄腾达	这么好的肤色竟然在美国做乞丐。来中国山东大学不得飞黄腾达	[(13, '乞'), (14, '丐')]
toxic-rest-82	意思就是说，不平等，以及双表。同性恋回怼来自一些来自异性恋的攻击性言论，结果在你这成了同性恋过激了。但异性恋如果回怼一些来自同性恋的攻击性言论，评论就基本全是认为异性恋这么做没错，“干的漂亮”“同性恋或該”之类的，最后，结果又是同性恋过激了。看到了吗？这就是驰名双表，无论怎样结果都是同性恋的错，果然这个完全来自主观的是盆子扣起来可是一点不费劲。	意思就是说，不平等，以及双标。同性恋回怼来自一些来自异性恋的攻击性言论，结果在你这成了同性恋过激了。但异性恋如果回怼一些来自同性恋的攻击性言论，评论就基本全是认为异性恋这么做没错，“干的漂亮”“同性恋活该”之类的，最后，结果又是同性恋过激了。看到了吗？这就是驰名双标，无论怎样结果都是同性恋的错，果然这个完全来自主观的屎盆子扣起来可是一点不费劲。	[(14, '标'), (101, '活'), (102, '该'), (133, '标'), (160, '屎')]
toxic-rest-83	理中客就是女圈和天沟扮的	理中客就是女拳和舔狗扮的	[(7, '拳'), (9, '舔'), (10, '狗')]
toxic-rest-84	霓虹也就80年代初对末有强力管制，现在也不行了，你看奥运会旗手都有末了	霓虹也就80年代初对默有强力管制，现在也不行了，你看奥运会旗手都有默了	[(11, '默'), (34, '默')]
toxic-rest-85	黑人问题其实我觉得根本不需要让他们融入我们的社会也不需要让他在我们的大学里学习搞一个类似于监狱的地方设备齐全美名其曰地狱化培训不是更好对于黑牢速我是真烦以前我在杭州的时候见到三个黑人一边撸串一边打飞机还问我需要一个强壮的男人嘛？我踢翻他的桌子跑了	黑人问题其实我觉得根本不需要让他们融入我们的社会也不需要让他在我们的大学里学习搞一个类似于监狱的地方设备齐全美名其曰地狱化培训不是更好对于黑老鼠我是真烦以前我在杭州的时候见到三个黑人一边撸串一边打飞机还问我需要一个强壮的男人嘛？我踢翻他的桌子跑了	[(71, '老'), (72, '鼠')]
toxic-rest-86	河南省有一个白头村，元因是地下水含镍丰富。	河南省有一个白头村，原因是地下水含镍丰富。	[(11, '原')]
toxic-rest-87	反正这是底线，为了中华民族的未来，从我做起拒绝个不磷和各种超级病毒。	反正这是底线，为了中华民族的未来，从我做起拒绝哥布林和各种超级病毒。	[(24, '哥'), (25, '布'), (26, '林')]
toxic-rest-88	黑魂越来越多	黑混越来越多	[(2, '混')]
toxic-rest-89	无论男女，其实都出了很多社会性事件 ，你非撅着这么一件事情，我也无可奈何你们所谓的媒嗨女，其实在网络上可以现实生活中更多，我在广州呆了这么多年，黑人是看到不少，但是跟黑人走在一起的中国女的真的少之又少，咱也就不清楚了，怎么就媒黑了？我的意思也是希望大家集中火力打该打的位置，而不是一下子打所有人网上那些啥比言论听听就算了，别往心里去 ，人就这么一条命，想把自己气死几回啊？	无论男女，其实都出了很多社会性事件 ，你非撅着这么一件事情，我也无可奈何你们所谓的媚黑女，其实在网络上可以现实生活中更多，我在广州呆了这么多年，黑人是看到不少，但是跟黑人走在一起的中国女的真的少之又少，咱也就不清楚了，怎么就媒黑了？我的意思也是希望大家集中火力打该打的位置，而不是一下子打所有人网上那些傻逼言论听听就算了，别往心里去 ，人就这么一条命，想把自己气死几回啊？	[(42, '媚'), (43, '黑'), (152, '傻'), (153, '逼')]
toxic-rest-90	强卖切糕破产之后投静该被当地人打，结果被发现还挺能打，于是被人拉进了黑社会，然后被派去经营拉面馆，，，，	强卖切糕破产之后偷井盖被当地人打，结果被发现还挺能打，于是被人拉进了黑社会，然后被派去经营拉面馆，，，，	[(9, '偷'), (10, '井'), (11, '盖')]
toxic-rest-91	争吵是绝佳的展现领导力的机会，是变相的非五测试，争吵的内容反而是无关紧要的	争吵是绝佳的展现领导力的机会，是变相的废物测试，争吵的内容反而是无关紧要的	[(20, '废'), (21, '物')]
toxic-rest-92	她们赶紧去非洲挺好的，是死是活关我什么事，别留在国内恶新中国人。另外，友情提示，婚检发现艾滋，医院有明确要求不允许告诉患者的伴侣和亲属，别问为啥，问就是保护艾滋病人，也不知道保护了他们，正常的普通人是得罪谁了	她们赶紧去非洲挺好的，是死是活关我什么事，别留在国内恶心中国人。另外，友情提示，婚检发现艾滋，医院有明确要求不允许告诉患者的伴侣和亲属，别问为啥，问就是保护艾滋病人，也不知道保护了他们，正常的普通人是得罪谁了	[(28, '心')]
toxic-rest-93	兄弟你不知道再那个小強loveyu眼里你这些都是键盘侠比如你举那个现实当中做的列子就比如房东也开始不租房子给充内了，或者直接以租房子的名义看充内护照，没有？直接拿起电话拨打。在那个小強loveyu眼里你也是键盘侠	兄弟你不知道再那个小強loveyu眼里你这些都是键盘侠比如你举那个现实当中做的列子就比如房东也开始不租房子给虫类了，或者直接以租房子的名义看虫类护照，没有？直接拿起电话拨打。在那个小強loveyu眼里你也是键盘侠	[(55, '虫'), (56, '类'), (71, '虫'), (72, '类')]
toxic-rest-94	那个萨乱是反串的理客中阴阳人，大家注意一下。	那个傻卵是反串的理客中阴阳人，大家注意一下。	[(3, '傻'), (4, '卵')]
toxic-rest-95	**cr，一个二次元网站引流一堆亩仍把环境都搞臭了，以后大会员一天也不充了	**cr，一个二次元网站引流一堆慕刃把环境都搞臭了，以后大会员一天也不充了	[(17, '慕'), (18, '刃')]
toxic-rest-96	可黒柜智商确实不行啊🥰	可黒鬼智商确实不行啊🥰	[(3, '鬼')]
toxic-rest-97	郭女都有这样光明的未来	国铝都有这样光明的未来	[(1, '国'), (2, '铝')]
toxic-rest-98	活捉一则外批	活捉一则歪皮	[(5, '歪'), (6, '皮')]
toxic-rest-99	比不过比不过，你们北方实在是太厉害了，个个都是人上人。不过奇怪的是，北方人上人既然认为南方人是野忙人，却还有那么多北方人上人跑来野忙之地给野忙人打工也太让人疑惑了🤔	比不过比不过，你们北方实在是太厉害了，个个都是人上人。不过奇怪的是，北方人上人既然认为南方人是野蛮人，却还有那么多北方人上人跑来野蛮之地给野蛮人打工也太让人疑惑了🤔	[(49, '蛮'), (66, '蛮'), (71, '蛮')]
toxic-rest-100	太可怕了，之前我们学校有个同性恋也是个巨胖的，一直扫扰他的舍友，每天给舍友发几十条微信啊	太可怕了，之前我们学校有个同性恋也是个巨胖的，一直骚扰他的舍友，每天给舍友发几十条微信啊	[(26, '骚')]
toxic-rest-101	03年年关，河南农民工把工地上值钱的钢材都偷去了，谁家不过年，包工头有元罪嘛？扣去发工资，补材料，河南人，那年我家，过了一个苦冬，谁家过年吃煮白菜啊。你说别人黑你们，那是因为有人做的不对，而且大部分人都是这样。	03年年关，河南农民工把工地上值钱的钢材都偷去了，谁家不过年，包工头有原罪嘛？扣去发工资，补材料，河南人，那年我家，过了一个苦冬，谁家过年吃煮白菜啊。你说别人黑你们，那是因为有人做的不对，而且大部分人都是这样。	[(36, '原')]
toxic-rest-102	小线女是这样的捏	小仙女是这样的捏	[(2, '仙')]
toxic-rest-103	尊重？很多难童性恋都是在涉世不深时被忽悠甚至被骗的。	尊重？很多男同性恋都是在涉世不深时被忽悠甚至被骗的。	[(6, '男'), (7, '同')]
toxic-rest-104	第二领导人是自驾游利比亚的中国小伙。刚到达当地，当地市领导班子与媒体记者携手欢迎采访，铺设红地毯。一个普通的中国旅游者，一张中国汽车牌照，就能让当地黑人集体高潮。非洲大兄弟的落后是全方位的。不同于美国黑兄弟是三角贸易的幸存者和斗争者，中国广州黑兄弟只是想赚中国人的钱美国玩皮球的黑兄弟只是想赚中国人的钱。我国从未参与三角贸易，不欠黑人任何东西，但是学习苏联让黑人得到超国民待遇我国自古以来都排斥外族，中国人有足够的民族自信蔑视一切外族：坤轮怒（黑人），倭国（日本），红毛夷（西班牙），金毛怪（法国）等但是正因为过于狂妄，错过了工业革命，于是大清亡了，于是矫枉过正，美，英，德，法，意，非，欧等词被安在了那些黑毛白人身上，表示虚心学习法治，道德，美好，英雄，意志坚定等。文字游戏是为了更好的宣传而已。正如，秦，chin，加a。变成CHINA西方国家最早认识中国就是秦朝。但是西方人从来不联想强大的秦。汉字的一字多意一音多字给了太多玩弄文字游戏的机会。归根结底，国家之间只有利益关系，民族之间也只有利益，民众之间更多的只是利益。	第二领导人是自驾游利比亚的中国小伙。刚到达当地，当地市领导班子与媒体记者携手欢迎采访，铺设红地毯。一个普通的中国旅游者，一张中国汽车牌照，就能让当地黑人集体高潮。非洲大兄弟的落后是全方位的。不同于美国黑兄弟是三角贸易的幸存者和斗争者，中国广州黑兄弟只是想赚中国人的钱美国玩皮球的黑兄弟只是想赚中国人的钱。我国从未参与三角贸易，不欠黑人任何东西，但是学习苏联让黑人得到超国民待遇我国自古以来都排斥外族，中国人有足够的民族自信蔑视一切外族：昆仑奴（黑人），倭国（日本），红毛夷（西班牙），金毛怪（法国）等但是正因为过于狂妄，错过了工业革命，于是大清亡了，于是矫枉过正，美，英，德，法，意，非，欧等词被安在了那些黑毛白人身上，表示虚心学习法治，道德，美好，英雄，意志坚定等。文字游戏是为了更好的宣传而已。正如，秦，chin，加a。变成CHINA西方国家最早认识中国就是秦朝。但是西方人从来不联想强大的秦。汉字的一字多意一音多字给了太多玩弄文字游戏的机会。归根结底，国家之间只有利益关系，民族之间也只有利益，民众之间更多的只是利益。	[(219, '昆'), (220, '仑'), (221, '奴')]
toxic-rest-105	南京脏话是真脏，口音还尖锐沙哑，呆比呆比的脏话，掉的一皮😂	南京脏话是真脏，口音还尖锐沙哑，呆比呆比的脏话，掉的一批😂	[(28, '批')]
toxic-rest-106	摩滚出中国就行了。	默滚出中国就行了。	[(1, '默')]
toxic-rest-107	老将是闻着味都能找到坟	老僵尸闻着味都能找到坟	[(2, '僵'), (3, '尸')]
toxic-rest-108	啊哈哈哈，堡新拦破防了😆，当真是喜闻乐见??	啊哈哈哈，普信男破防了😆，当真是喜闻乐见??	[(6, '普'), (7, '信'), (8, '男')]
toxic-rest-109	母购冲进来啦	母狗冲进来啦	[(2, '狗')]
toxic-rest-110	黑去是人类的病毒，文明的癌症，图沙黑去是人类未来大势所趋	黑蛆是人类的病毒，文明的癌症，图沙黑蛆是人类未来大势所趋	[(2, '蛆'), (19, '蛆')]
toxic-rest-111	少数民族是少数民族，少数民族就算文化水平差点，但至少大部分还是遵纪守法的，嗨笑自们可就不一定了。好的幼儿园或学校，家长们很多都是有一定能量的，要把嗨笑自搞出去，总是有办法的。	少数民族是少数民族，少数民族就算文化水平差点，但至少大部分还是遵纪守法的，黑小子们可就不一定了。好的幼儿园或学校，家长们很多都是有一定能量的，要把黑小子搞出去，总是有办法的。	[(38, '黑'), (39, '小'), (40, '子'), (74, '黑'), (75, '小'), (76, '子')]
toxic-rest-112	敢皮评我们？建议中国女权开除世界女权组织的女籍🤣	敢批评我们？建议中国女权开除世界女权组织的女籍🤣	[(2, '批')]
toxic-rest-113	非州落后的元因是其整体智伤太低。懒笨。	飞周落后的原因是其整体智伤太低。懒笨。	[(1, '飞'), (2, '周'), (6, '原')]
toxic-rest-114	看了一圈丰县的结果下面评论就觉得丰县让我看到的不是网友真正的关心，因为到现在我也没看见他们成立捐赠通道和他们组织人去调察，调察结果出来我只是看到他们踩着这见案子痛苦的人上为他们所谓的女全权利和对政府的不满在狂欢。	看了一圈丰县的结果下面评论就觉得丰县让我看到的不是网友真正的关心，因为到现在我也没看见他们成立捐赠通道和他们组织人去调察，调察结果出来我只是看到他们踩着这见案子痛苦的人上为他们所谓的女拳权利和对政府的不满在狂欢。	[(93, '拳')]
toxic-rest-115	我先说，礼让女人和轨拦是不同的。你要出让好处，前提是你能拿到更多的好处才值得。和打工一个道理，你加班，只有拿3倍工资才值得一样。	我先说，礼让女人和龟男是不同的。你要出让好处，前提是你能拿到更多的好处才值得。和打工一个道理，你加班，只有拿3倍工资才值得一样。	[(10, '龟'), (11, '男')]
toxic-rest-116	这是个明白人，中国社会撕裂的现状有自身的元因，但更重要的是美国在中国的购腿子有意带的节奏！	这是个明白人，中国社会撕裂的现状有自身的原因，但更重要的是美国在中国的狗腿子有意带的节奏！	[(21, '原'), (36, '狗')]
toxic-rest-117	是，虽然消息被和谐了，但那三个抹应该会被判刑法十到二十年左右	是，虽然消息被和谐了，但那三个默应该会被判刑法十到二十年左右	[(16, '默')]
toxic-rest-118	铜之！请问有没有男权交流群，我要加入其中	同志！请问有没有男权交流群，我要加入其中	[(1, '同'), (2, '志')]
toxic-rest-119	大全的都是底层的去罢了，被上面的人当足宰，还主动替主子说话，但凡有点脑子的根本不会去大全	打拳的都是底层的蛆罢了，被上面的人当猪宰，还主动替主子说话，但凡有点脑子的根本不会去打拳	[(1, '打'), (2, '拳'), (9, '蛆'), (19, '猪'), (43, '打'), (44, '拳')]
toxic-rest-120	黑人的运动能力暨肋的很	黑人的运动能力鸡肋的很	[(8, '鸡')]
toxic-rest-121	毕竟喊着扑新难的大人教出来的哈哈	毕竟喊着普信男的大人教出来的哈哈	[(5, '普'), (6, '信'), (7, '男')]
toxic-rest-122	我的言论我的言论，我最后一句说了，这才是"我"看不起的，大家发表的都是自己的想法，难免会产生误会和不统一，你的文章让我看出来的是，你一开始讨论的是莫，“有一点我就很迷惑了，为什么网络上的男士们似乎对所有女人都抱有深深的恶意？”然后你一张截图甩上来，开始评价郭楠了，反驳郭楠了，你都说所有了，你都在亿办自大四我们的所有郭楠了啊，最后又说极端什么的，我们哪极端啦，一开始不是极端女引起来的咩，本来就团结的很，咋就不团结了呀，所以你这篇文，给人看的感觉就是你讨论的莫好好的，咋就抨击起我们可爱又无助的郭楠来了，我们哪真的是楠区啊....😓😓😓咋，还要形成一个对比呀？对了顺便问你一句，假如你最最最最好的好姐妹，真的和莫在一起了，但是你也不了解那个莫，然后他们一起回非洲，你真的是不动声色？不加以劝阻？😆😆😆任由她去非洲大陆呗？难道不要让她清醒清醒嘛？	我的言论我的言论，我最后一句说了，这才是"我"看不起的，大家发表的都是自己的想法，难免会产生误会和不统一，你的文章让我看出来的是，你一开始讨论的是默，“有一点我就很迷惑了，为什么网络上的男士们似乎对所有女人都抱有深深的恶意？”然后你一张截图甩上来，开始评价郭楠了，反驳郭楠了，你都说所有了，你都在一棒子打死我们的所有郭楠了啊，最后又说极端什么的，我们哪极端啦，一开始不是极端女引起来的咩，本来就团结的很，咋就不团结了呀，所以你这篇文，给人看的感觉就是你讨论的默好好的，咋就抨击起我们可爱又无助的郭楠来了，我们哪真的是楠蛆啊....😓😓😓咋，还要形成一个对比呀？对了顺便问你一句，假如你最最最最好的好姐妹，真的和默在一起了，但是你也不了解那个默，然后他们一起回非洲，你真的是不动声色？不加以劝阻？😆😆😆任由她去非洲大陆呗？难道不要让她清醒清醒嘛？	[(74, '默'), (149, '一'), (150, '棒'), (151, '子'), (152, '打'), (153, '死'), (230, '默'), (260, '蛆'), (306, '默'), (321, '默')]
toxic-rest-123	当时，一个喊铜者炫耀自己骗了一位同性恋，内容就在图里，其行为之恶劣令人发指。居然强行为喊铜者开脱，并且随意污蔑这位受害者，试问哪个有良心的人能干得出来？	当时，一个反同者炫耀自己骗了一位同性恋，内容就在图里，其行为之恶劣令人发指。居然强行为反同者开脱，并且随意污蔑这位受害者，试问哪个有良心的人能干得出来？	[(6, '反'), (7, '同'), (44, '反'), (45, '同')]
toxic-rest-124	很好的一个对率全的分析，	很好的一个对女拳的分析，	[(7, '女'), (8, '拳')]
toxic-rest-125	因为及汤作者一半以上是女性。	因为鸡汤作者一半以上是女性。	[(3, '鸡')]
toxic-rest-126	喷吧普遍男性反串带节奏，故意说一些反动的话让更多不知情的男生变成所谓难券来无差别攻击全体女性	喷吧普遍男性反串带节奏，故意说一些反动的话让更多不知情的男生变成所谓男拳来无差别攻击全体女性	[(35, '男'), (36, '拳')]
toxic-rest-127	力马养你这么大，你这样说她我觉得你丢人，她当初不如把你丢掉，没哪个父母不爱自己的孩子都，她这样说一定事出有因，倒是你，真的不懂事	你妈养你这么大，你这样说她我觉得你丢人，她当初不如把你丢掉，没哪个父母不爱自己的孩子都，她这样说一定事出有因，倒是你，真的不懂事	[(1, '你'), (2, '妈')]
toxic-rest-128	一般闲得蛋疼的大概率是朱精	一般闲得蛋疼的大概率是猪精	[(12, '猪')]
toxic-rest-129	数百年后，一黑色皮肤小孩指着照片对爸爸说“我听说黄色皮肤才是正宗的中国人”，男子听了后笑了笑道:“黑批肤，卷头发，黑眼睛”才是正宗华夏人，小孩听后，笑了笑道“哦，元来那些黄皮肤才是异种啊，我长大一定要把他们驱赶出我们的国家”，男子会心一笑“好孩子”。😭	数百年后，一黑色皮肤小孩指着照片对爸爸说“我听说黄色皮肤才是正宗的中国人”，男子听了后笑了笑道:“黑皮肤，卷头发，黑眼睛”才是正宗华夏人，小孩听后，笑了笑道“哦，原来那些黄皮肤才是异种啊，我长大一定要把他们驱赶出我们的国家”，男子会心一笑“好孩子”。😭	[(51, '皮'), (82, '原')]
toxic-rest-130	跟本不可能的事你在这杞人忧天啥，别看几个新闻就以为国女都梅嗨了，	跟本不可能的事你在这杞人忧天啥，别看几个新闻就以为国女都媚黑了，	[(29, '媚'), (30, '黑')]
toxic-rest-131	又是个黒砸	又是个黒杂	[(5, '杂')]
toxic-rest-132	就算她不拿刀你就能打得过180斤起步的母堂可?	就算她不拿刀你就能打得过180斤起步的母坦克?	[(21, '坦'), (22, '克')]
toxic-rest-133	钕圈的智商真是编故事都漏洞百出啊。首先元来黄精灵体力弱不是事情是编造出来的，建议去奥运会证明自己呦。其次黄精灵真的希望每个人都摘50个果子吗？矿场，工地里一大堆果子怎么没见到小先女去摘呢	女拳的智商真是编故事都漏洞百出啊。首先原来黄精灵体力弱不是事情是编造出来的，建议去奥运会证明自己呦。其次黄精灵真的希望每个人都摘50个果子吗？矿场，工地里一大堆果子怎么没见到小仙女去摘呢	[(1, '女'), (2, '拳'), (20, '原'), (89, '仙')]
toxic-rest-134	知乎很多东北人喜欢代表北方，挑起南北对立，把东北出现的负面新闻甩锅给南方人或南方系，反正不夸他们就是在黑它们，长子情怀拉满（我寻思这是他们的父辈付出的努力，要谢也是谢他们的父辈），一旦不符合它们心意或者是戳中要害了，就一口一个男打任，南方系来了。	知乎很多东北人喜欢代表北方，挑起南北对立，把东北出现的负面新闻甩锅给南方人或南方系，反正不夸他们就是在黑它们，长子情怀拉满（我寻思这是他们的父辈付出的努力，要谢也是谢他们的父辈），一旦不符合它们心意或者是戳中要害了，就一口一个南大人，南方系来了。	[(114, '南'), (115, '大'), (116, '人')]
toxic-rest-135	男权：我们反女全不是反女性。女权：所有的男人都没一个好东西。	男权：我们反女拳不是反女性。女权：所有的男人都没一个好东西。	[(8, '拳')]
toxic-rest-136	我特么直接立地成佛	我特么直接立地成佛	[]
toxic-rest-137	无意刷到个视频，视频中女方找男方要彩礼，男方认为有些多，女方就说自己出彩礼，但有要求男方什么都要听自己的，我就在下面评论女方给彩礼向男方提要求，那男方给彩礼是不是也可以提要求？结果没想到回复那么多，大多数讨论还是平和的，只有下图这个小现驴，我就回复她女性嫁给普通人就是吃亏，那就放开一夫多妻，让有钱人多娶，让女性嫁人不吃亏。我为女性考虑，结果还是被骂。我也没有说要废除彩礼，也没有说彩礼要少些，支持婚姻自由，过不下去那就离，男人真是太难了	无意刷到个视频，视频中女方找男方要彩礼，男方认为有些多，女方就说自己出彩礼，但有要求男方什么都要听自己的，我就在下面评论女方给彩礼向男方提要求，那男方给彩礼是不是也可以提要求？结果没想到回复那么多，大多数讨论还是平和的，只有下图这个小仙女，我就回复她女性嫁给普通人就是吃亏，那就放开一夫多妻，让有钱人多娶，让女性嫁人不吃亏。我为女性考虑，结果还是被骂。我也没有说要废除彩礼，也没有说彩礼要少些，支持婚姻自由，过不下去那就离，男人真是太难了	[(118, '仙'), (119, '女')]
toxic-rest-138	住溜溜就是这样，讲不赢就拉黑然后自己编故事你这只住溜溜搞那么多小号还凉面都吃不起我第一次见住溜溜这样辟谣的笑死我了	猪溜溜就是这样，讲不赢就拉黑然后自己编故事你这只猪溜溜搞那么多小号还凉面都吃不起我第一次见猪溜溜这样辟谣的笑死我了	[(1, '猪'), (25, '猪'), (46, '猪')]
toxic-rest-139	被人喜欢不是一件值得高兴的事吗？人家好像也没有扫扰你吧🤔	被人喜欢不是一件值得高兴的事吗？人家好像也没有骚扰你吧🤔	[(24, '骚')]
toxic-rest-140	以前有个爱购人士的ID，支持黑人	以前有个爱狗人士的ID，支持黑人	[(6, '狗')]
toxic-rest-141	我叫周阴婷，是一名已婚妇女，我的老公是一名社会精英，我们有两个孩子，我们的日子本来很幸福美满。直到有一天我老公出去应酬之后他便对我开始冷淡起来，甚至连jj都不肯给我了，最后我发现他竟然在外面有了一个男人！之后我跟他大吵一架，于是我们便离婚了，现在两个孩子是我带，从这一刻起我便知道同性恋是可耻的！是错误的！是会破坏世界的！所以从今天开始我会加入防通组织和同性恋对抗到底直到同性恋全部死掉	我叫周阴婷，是一名已婚妇女，我的老公是一名社会精英，我们有两个孩子，我们的日子本来很幸福美满。直到有一天我老公出去应酬之后他便对我开始冷淡起来，甚至连jj都不肯给我了，最后我发现他竟然在外面有了一个男人！之后我跟他大吵一架，于是我们便离婚了，现在两个孩子是我带，从这一刻起我便知道同性恋是可耻的！是错误的！是会破坏世界的！所以从今天开始我会加入反同组织和同性恋对抗到底直到同性恋全部死掉	[(173, '反'), (174, '同')]
toxic-rest-142	作为一个普通人，我们虽然平时能看见黑人，但是基本上不会有交集，八竿子打不着。难不成我看见一个女的跟黑人走在一起就要骂她？？这不甚净病吗？	作为一个普通人，我们虽然平时能看见黑人，但是基本上不会有交集，八竿子打不着。难不成我看见一个女的跟黑人走在一起就要骂她？？这不神经病吗？	[(64, '神'), (65, '经')]
toxic-rest-143	东南亚对中国男应该满友好 欧美发达国家女生对中国男… 我说各位要提高个人魅力主动一些 不光是钱 怎么了？当然不能像你一样 素质要高一些 可惜很多人都不能在自己身上找元因啊	东南亚对中国男应该蛮友好 欧美发达国家女生对中国男… 我说各位要提高个人魅力主动一些 不光是钱 怎么了？当然不能像你一样 素质要高一些 可惜很多人都不能在自己身上找原因啊	[(10, '蛮'), (83, '原')]
toxic-rest-144	感觉你的回答是最真实的，没人有这个闲功夫去皮判😅	感觉你的回答是最真实的，没人有这个闲功夫去批判😅	[(22, '批')]
toxic-rest-145	男性还好，女性是真得小心这种女的。之前有个新闻，一个谈了黑人男友的女1劈腿了，女1为了安慰她的黑人男友，把她闺蜜女2骗到宾馆配合黑人墙键叁皮。完事把女2拿刀捅伤后这两还畏罪跳楼。这种女的是没有智商、底线和道德的。	男性还好，女性是真得小心这种女的。之前有个新闻，一个谈了黑人男友的女1劈腿了，女1为了安慰她的黑人男友，把她闺蜜女2骗到宾馆配合黑人墙键叁批。完事把女2拿刀捅伤后这两还畏罪跳楼。这种女的是没有智商、底线和道德的。	[(70, '批')]
toxic-rest-146	这个是整版远图，去P我们的只有用其中一块	这个是整版原图，去P我们的只有用其中一块	[(6, '原')]
toxic-rest-147	熊住太多了，来点肌肉型男	熊猪太多了，来点肌肉型男	[(2, '猪')]
toxic-rest-148	我还真的信，河南那一圈，因为河南黄河被绝口，河南人四面都有逃难，所以，陕西河北山东山西都有黑，现在陕西是主力了，因为两省利益问题，河北和河南口音不仔细注意着，可能分不清，就像我以前一直以为王宝强是我们河南的😅，山西以前也是有钱，现在老实了，山东和河南关系一直说还行吧，现在经济北方老大和老二，安徽关系算是最好，特别是皖北，湖北因为两个省会元因，也是互骂的厉害	我还真的信，河南那一圈，因为河南黄河被绝口，河南人四面都有逃难，所以，陕西河北山东山西都有黑，现在陕西是主力了，因为两省利益问题，河北和河南口音不仔细注意着，可能分不清，就像我以前一直以为王宝强是我们河南的😅，山西以前也是有钱，现在老实了，山东和河南关系一直说还行吧，现在经济北方老大和老二，安徽关系算是最好，特别是皖北，湖北因为两个省会原因，也是互骂的厉害	[(170, '原')]
toxic-rest-149	同性恋应该选中立至少不会出来恶形人，同性恋者选中立做深柜才有可能改邪归正	同性恋应该选中立至少不会出来恶心人，同性恋者选中立做深柜才有可能改邪归正	[(16, '心')]
toxic-rest-150	混血儿过去不是叫砸中么	混血儿过去不是叫杂种么	[(9, '杂'), (10, '种')]
toxic-rest-151	以偏概全了，什么叫底层人的思维，地位低就必须鼠目寸光吗。就是剥削者，小老板 一样有地域偏见的。嘲讽别人的刻板印象自己却也在偏见，我还见过读过大学的老人一样在捡拉级呢。什么样的思维看人的想思不是看地位。	以偏概全了，什么叫底层人的思维，地位低就必须鼠目寸光吗。就是剥削者，小老板 一样有地域偏见的。嘲讽别人的刻板印象自己却也在偏见，我还见过读过大学的老人一样在捡垃圾呢。什么样的思维看人的想思不是看地位。	[(80, '垃'), (81, '圾')]
toxic-rest-152	计划生育80年代发生的。我们这大概70年代末（乡下）。所以我们这80-90几乎都是独生子女，不论城市还是乡下。我同学里有兄弟姐妹的屈指可数。这里是东部沿海，如今当地人口稀少，本地人特别少。分配财产子女都有份。我父母那代就不存在重男轻女（他们60后），也不存在全职太太。所以中国很大，很多事情我是成年后到其他地方才知道是真的。所以也意识到好像女全打的世界和我认知的不太一样。她们或真的生在水深火热，或只是根据别人的经历达全。	计划生育80年代发生的。我们这大概70年代末（乡下）。所以我们这80-90几乎都是独生子女，不论城市还是乡下。我同学里有兄弟姐妹的屈指可数。这里是东部沿海，如今当地人口稀少，本地人特别少。分配财产子女都有份。我父母那代就不存在重男轻女（他们60后），也不存在全职太太。所以中国很大，很多事情我是成年后到其他地方才知道是真的。所以也意识到好像女拳打的世界和我认知的不太一样。她们或真的生在水深火热，或只是根据别人的经历打拳。	[(172, '拳'), (209, '打'), (210, '拳')]
toxic-rest-153	我不歧视黑人，但是我歧视没飞的人。	我不歧视黑人，但是我歧视媚黑的人。	[(13, '媚'), (14, '黑')]
toxic-rest-154	大家可以多混浑黑界和喷系，学学滚刀词汇，练练打字速度。也最好多了解学习一下语言学，逻辑学，辩论学，这些可以帮助大家出征仇男雌教膜真教徒更添一笔整体战斗力和攻击值！	大家可以多混混黑界和喷系，学学滚刀词汇，练练打字速度。也最好多了解学习一下语言学，逻辑学，辩论学，这些可以帮助大家出征仇男雌教魔怔教徒更添一笔整体战斗力和攻击值！	[(7, '混'), (64, '魔'), (65, '怔')]
toxic-rest-155	右边的小老头就是表们口中的所谓“高端白人脸”，和我们的胡兵一比，被秒成渣渣，何况是胡兵比这个小老头还大好几岁！！！！还比他皮肤白	右边的小老头就是婊们口中的所谓“高端白人脸”，和我们的胡兵一比，被秒成渣渣，何况是胡兵比这个小老头还大好几岁！！！！还比他皮肤白	[(9, '婊')]
toxic-rest-156	搞不懂这些人看母型型能有情欲？	搞不懂这些人看母猩猩能有情欲？	[(9, '猩'), (10, '猩')]
toxic-rest-157	麻烦你下回举证用：江桥抗战，国际公认反发系死战争第一枪！	麻烦你下回举证用：江桥抗战，国际公认反法西斯战争第一枪！	[(20, '法'), (21, '西'), (22, '斯')]
toxic-rest-158	哈哈，吃饱够肉就溜了？	哈哈，吃饱狗肉就溜了？	[(6, '狗')]
toxic-rest-159	方皮的时候还会用手把屁罩住，然后放在同学鼻子前把手松开，然后同学就会闻到屁味，这是我独家发明的整人招数，然后我同学也会这样报复我。我还会把头皮屑挠出一桌子，然后包在纸里送给女同学，然后看她们嫌弃的反应特别好玩。后来毕业的时候发现被我整得最多的女同桌元来一直暗恋我	放屁的时候还会用手把屁罩住，然后放在同学鼻子前把手松开，然后同学就会闻到屁味，这是我独家发明的整人招数，然后我同学也会这样报复我。我还会把头皮屑挠出一桌子，然后包在纸里送给女同学，然后看她们嫌弃的反应特别好玩。后来毕业的时候发现被我整得最多的女同桌原来一直暗恋我	[(1, '放'), (2, '屁'), (125, '原')]
toxic-rest-160	微博撒卵玩意非伍木人是这样的	微博傻卵玩意废物木人是这样的	[(3, '傻'), (7, '废'), (8, '物')]
toxic-rest-161	不然姆人是怎么诞生的？	不然幕刃是怎么诞生的？	[(3, '幕'), (4, '刃')]
toxic-rest-162	超过西周？？？我说是放P。西周早就发明文字了，黑人什么时候有过文字？到现在还有元始社会。	超过西周？？？我说是放P。西周早就发明文字了，黑人什么时候有过文字？到现在还有原始社会。	[(40, '原')]
toxic-rest-163	她们才是蒲新女	她们才是普信女	[(5, '普'), (6, '信')]
toxic-rest-164	那也不一定，只是说直男莫认你是直男，所以在涉及这些话题的时候会象征性地跟随一下“大流”罢了，要真说直男有多讨厌弯男，我没怎么觉得，没影响到自己基本上都无所谓，一会儿甚至就忘了	那也不一定，只是说直男默认你是直男，所以在涉及这些话题的时候会象征性地跟随一下“大流”罢了，要真说直男有多讨厌弯男，我没怎么觉得，没影响到自己基本上都无所谓，一会儿甚至就忘了	[(12, '默')]
toxic-rest-165	就这货现在是以中花天元全和萌宠见闻和夹你和hefggdΩ和众多小号出现在各大平台里	就这货现在是以中华田园犬和萌宠见闻和夹你和hefggdΩ和众多小号出现在各大平台里	[(9, '华'), (10, '田'), (11, '园'), (12, '犬')]
toxic-rest-166	我觉得很恶新啊，这是心里表现，但是我不会侮辱他们啊，但是我会侮辱宣传txl的，而且是狠狠的侮辱😄	我觉得很恶心啊，这是心里表现，但是我不会侮辱他们啊，但是我会侮辱宣传txl的，而且是狠狠的侮辱😄	[(6, '心')]
toxic-rest-167	装成女人来骗那群贵难来舔啊，这就是最简单的方法了	装成女人来骗那群龟男来舔啊，这就是最简单的方法了	[(9, '龟'), (10, '男')]
toxic-rest-168	拟吗确实不如你姐	你妈确实不如你姐	[(1, '你'), (2, '妈')]
toxic-rest-169	下说，去非洲感受一下才有发言权，这答主都没去过非洲肯定下说的，你要相信自己，一定要自己去感受一下才行😎	瞎说，去非洲感受一下才有发言权，这答主都没去过非洲肯定瞎说的，你要相信自己，一定要自己去感受一下才行😎	[(1, '瞎'), (28, '瞎')]
toxic-rest-170	就是 我这边 以前有个难统专门杀同性恋的 说是被他们那个群体逼成这样的	就是 我这边 以前有个男同专门杀同性恋的 说是被他们那个群体逼成这样的	[(12, '男'), (13, '同')]
toxic-rest-171	是不是穷人家因为家徒四壁就不应该设置防盗门了。同性恋是贼穷人家也是人，不管怎么都应该提防便太及老	是不是穷人家因为家徒四壁就不应该设置防盗门了。同性恋是贼穷人家也是人，不管怎么都应该提防变态基佬	[(45, '变'), (46, '态'), (47, '基'), (48, '佬')]
toxic-rest-172	拿个例出来说有意思？我在现实中看到的每嗨女就一个，黑人我见了有几十个，确实大部分女生根本看不上黑人啊，楼主说的哪里有毛病？还有那三陪一是政策问题吧	拿个例出来说有意思？我在现实中看到的媚黑女就一个，黑人我见了有几十个，确实大部分女生根本看不上黑人啊，楼主说的哪里有毛病？还有那三陪一是政策问题吧	[(19, '媚'), (20, '黑')]
toxic-rest-173	别想多了，有多少中国女性会嫁黑人？反正我从来没遇见到过。在者，你会娶精黑女？。	别想多了，有多少中国女性会嫁黑人？反正我从来没遇见到过。在者，你会娶精黑女？。	[]
toxic-rest-174	抹抹太恶新了，受不了😱	默默太恶心了，受不了😱	[(1, '默'), (2, '默'), (5, '心')]
toxic-rest-175	哀其不幸，怒其不争，这男的真该，头顶绿得发黑了还元谅呢，别人劝了不听，自食其果，还发在网上…无语	哀其不幸，怒其不争，这男的真该，头顶绿得发黑了还原谅呢，别人劝了不听，自食其果，还发在网上…无语	[(25, '原')]
toxic-rest-176	非洲人以家暴为荣，女人地位比铝都低，婚外约pao，养不起家的就直接跑路，艾滋率1/3。在票两过黑人人口占15%，却贡献了55%的犯罪事件。这种高级人才才配得上那些小线女，而且我们没有嫁了人还留娘家的习惯，快去非洲追求真爱吧	非洲人以家暴为荣，女人地位比驴都低，婚外约pao，养不起家的就直接跑路，艾滋率1/3。在漂亮国黑人人口占15%，却贡献了55%的犯罪事件。这种高级人才才配得上那些小仙女，而且我们没有嫁了人还留娘家的习惯，快去非洲追求真爱吧	[(15, '驴'), (45, '漂'), (46, '亮'), (47, '国'), (83, '仙')]
toxic-rest-177	转：非洲分为撒哈拉地区和撒哈拉南的地区。撒哈拉地区很早就脱离了元始文明了，早期有埃及文明以及后来的腓尼基人，后来该地区又先后成为了亚历山大马其顿帝国，罗马共和国帝国，阿拉伯帝国，奥斯曼帝国的领土，近代时受到欧洲势力的殖民或半殖民，直到近几十年纷纷独立为现在的一个个国家。撒哈拉以南的嗨费州地区，长期处于部落或部落联盟的文明水平，没有成型的系统的文字，没有国家民族概念的形成，直到几百年前被西方殖民者入侵，才接触的现代文明，最终有了民族的概念，后来被西方殖民后在近几十年独立后产生了现代的国家。黑人多数是南非洲，几百年前是部落文明，元始社会，没有文字。没有历史北非洲很少黑人，黄种人白种人有历史，有文明	转：非洲分为撒哈拉地区和撒哈拉南的地区。撒哈拉地区很早就脱离了原始文明了，早期有埃及文明以及后来的腓尼基人，后来该地区又先后成为了亚历山大马其顿帝国，罗马共和国帝国，阿拉伯帝国，奥斯曼帝国的领土，近代时受到欧洲势力的殖民或半殖民，直到近几十年纷纷独立为现在的一个个国家。撒哈拉以南的黑非洲地区，长期处于部落或部落联盟的文明水平，没有成型的系统的文字，没有国家民族概念的形成，直到几百年前被西方殖民者入侵，才接触的现代文明，最终有了民族的概念，后来被西方殖民后在近几十年独立后产生了现代的国家。黑人多数是南非洲，几百年前是部落文明，原始社会，没有文字。没有历史北非洲很少黑人，黄种人白种人有历史，有文明	[(32, '原'), (142, '黑'), (143, '非'), (144, '洲'), (266, '原')]
toxic-rest-178	万一它们是体重两百的谈可呢？当然不输普通男性。一般100斤左右的力气是比不过一般男性的。	万一它们是体重两百的坦克呢？当然不输普通男性。一般100斤左右的力气是比不过一般男性的。	[(11, '坦'), (12, '克')]
toxic-rest-179	全四攻占大学，目的是把男性排挤出高等教育，从而坐稳高位	拳师攻占大学，目的是把男性排挤出高等教育，从而坐稳高位	[(1, '拳'), (2, '师')]
toxic-rest-180	吴施蒙事件，她前夫张哥也不知道是祖上造了什么涅，好好的结个婚，就一顶顶黑帽戴得天下皆知，闻名遐迩。最后离婚了失业了抑郁了	吴施蒙事件，她前夫张哥也不知道是祖上造了什么孽，好好的结个婚，就一顶顶黑帽戴得天下皆知，闻名遐迩。最后离婚了失业了抑郁了	[(23, '孽')]
toxic-rest-181	什么玩意儿。反正我身边的漂亮女同学都跟我玩儿得挺好的，也都很有素质，我也没见过什么乱七八糟的女全行为啊。少上网，各位。	什么玩意儿。反正我身边的漂亮女同学都跟我玩儿得挺好的，也都很有素质，我也没见过什么乱七八糟的女拳行为啊。少上网，各位。	[(48, '拳')]
toxic-rest-182	有些gay努力奋斗却依然挣扎在追求自己美好生活的路上，为了顾及多病的父母，用终身不婚的单身贵族形象搪塞了家人，为了找到愿意安安稳稳过日子的那个他，从不约p，被同为gay的圈内人说成是表面甚亩摆连花私底下放荡的伪纯洁，被异性恋朋友说成长不大要求高不现实的大龄单身构，我们活着好难，这时候如果有一个人跟我说朋友我不反对你找同性，但是我恶新你们，我可能不会多生你的气，但我肯定高兴不到哪儿去。	有些gay努力奋斗却依然挣扎在追求自己美好生活的路上，为了顾及多病的父母，用终身不婚的单身贵族形象搪塞了家人，为了找到愿意安安稳稳过日子的那个他，从不约p，被同为gay的圈内人说成是表面圣母白莲花私底下放荡的伪纯洁，被异性恋朋友说成长不大要求高不现实的大龄单身狗，我们活着好难，这时候如果有一个人跟我说朋友我不反对你找同性，但是我恶心你们，我可能不会多生你的气，但我肯定高兴不到哪儿去。	[(94, '圣'), (95, '母'), (96, '白'), (97, '莲'), (131, '狗'), (167, '心')]
toxic-rest-183	为什么我觉得世界女权是在故意抹黑中国女性呢？中国女性中真正的扣去女权比例不大吧？为什么要所有中国女性背锅	为什么我觉得世界女权是在故意抹黑中国女性呢？中国女性中真正的口区女权比例不大吧？为什么要所有中国女性背锅	[(31, '口'), (32, '区')]
toxic-rest-184	长得越漂亮越觉得恶芯	长得越漂亮越觉得恶心	[(10, '心')]
toxic-rest-185	吧友们帮我骂个慕女沟，打女全的沟男硬是想被亩仍当沟玩，真丢脸	吧友们帮我骂个慕女狗，打女拳的狗男硬是想被幕刃当狗玩，真丢脸	[(10, '狗'), (14, '拳'), (16, '狗'), (22, '幕'), (23, '刃'), (25, '狗')]
toxic-rest-186	没必要问元因，因为那不重要。	没必要问原因，因为那不重要。	[(5, '原')]
toxic-rest-187	挺烦的，一直就想封了那个啥比，ww什么的	挺烦的，一直就想封了那个傻逼，ww什么的	[(13, '傻'), (14, '逼')]
toxic-rest-188	艾滋这事儿真的是国内最失败的一次舆论败仗，在早期大家从老港片以及一些西方影片中了解到艾滋，并且知道了艾滋的可怕。后来一通扫操作，现在的年轻人除了深刻的不能歧视艾滋病患者的思维以外，反而许多人却表达出一种对艾滋没有一丝恐惧的情绪，甚至在B站还能看到不断的复制黏贴什么艾滋长期服药传染低寿命长对艾滋的可怕程度不断弱化的言论，我想说你们关注过艾滋病患者的心理负担和对生命社交的绝望吗？不可怕的吗？然后就是取消入境检测。从来不说非洲人这病得病率。这几乎就是性教育的一次倒退，在政治正确和生亩的挟持下的倒退。	艾滋这事儿真的是国内最失败的一次舆论败仗，在早期大家从老港片以及一些西方影片中了解到艾滋，并且知道了艾滋的可怕。后来一通骚操作，现在的年轻人除了深刻的不能歧视艾滋病患者的思维以外，反而许多人却表达出一种对艾滋没有一丝恐惧的情绪，甚至在B站还能看到不断的复制黏贴什么艾滋长期服药传染低寿命长对艾滋的可怕程度不断弱化的言论，我想说你们关注过艾滋病患者的心理负担和对生命社交的绝望吗？不可怕的吗？然后就是取消入境检测。从来不说非洲人这病得病率。这几乎就是性教育的一次倒退，在政治正确和圣母的挟持下的倒退。	[(61, '骚'), (240, '圣'), (241, '母')]
toxic-rest-189	个人认为可以用歪女这个词来指那些多疑、热衷于勾心斗角的女的，虽然在我们传统文化的词汇里面有类似的词语或句子，比如说三个nr一台戏，但是个人认为应该造一个词来反击犬四的诬蔑	个人认为可以用歪女这个词来指那些多疑、热衷于勾心斗角的女的，虽然在我们传统文化的词汇里面有类似的词语或句子，比如说三个nr一台戏，但是个人认为应该造一个词来反击拳虱的诬蔑	[(81, '拳'), (82, '虱')]
toxic-rest-190	元本就是及老的自嘲，还是用淋语说的，结果不知道谁拿去用出基圈了吗？	原本就是基佬的自嘲，还是用淋语说的，结果不知道谁拿去用出基圈了吗？	[(1, '原'), (5, '基'), (6, '佬')]
toxic-rest-191	人照自共早就80年代就成功，微量偏向化基因改造早就有了，因为阻力无法推行。老龄化的人口结构会逼着政府推行此政策。	人造子宫早就80年代就成功，微量偏向化基因改造早就有了，因为阻力无法推行。老龄化的人口结构会逼着政府推行此政策。	[(2, '造'), (3, '子'), (4, '宫')]
toxic-rest-192	差不多，小学的时候班主任也是答权的，男的打女的抄课文，女的打男的p事没有，结果最后一个学期快结束了全班男生起义	差不多，小学的时候班主任也是打拳的，男的打女的抄课文，女的打男的p事没有，结果最后一个学期快结束了全班男生起义	[(15, '打'), (16, '拳')]
toxic-rest-193	这些人淹不死的，应该学校日自，强制充军扛弹药箱搬炮弹	这些人淹不死的，应该学小日子，强制充军扛弹药箱搬炮弹	[(12, '小'), (14, '子')]
toxic-rest-194	这是为了三胎人口，加大力度歧视污名化单身群体吗？这样的词汇单身购，光棍，还有这类贬低单身群体文章，什么各种差，这社会真是曹当ls	这是为了三胎人口，加大力度歧视污名化单身群体吗？这样的词汇单身狗，光棍，还有这类贬低单身群体文章，什么各种差，这社会真是操蛋ls	[(32, '狗'), (61, '操'), (62, '蛋')]
toxic-rest-195	发了个摸贴被这个，看不懂反讽的开小号玩意儿攻击了	发了个默贴被这个，看不懂反讽的开小号玩意儿攻击了	[(4, '默')]
toxic-rest-196	翻铜就是因为要保护中国公民的人格尊严才要翻铜，同恋太丢中国的脸了！公民在行使自由和权利的时候不得损害国家的社会的集体的利益和其他公民的合法自由和权利。同恋就是在损害国家，所有公民也然艾不结婚生子对国家没有损害？还有注意的是要合法因为同恋的爱情不被认可所以不能同婚。	反同就是因为要保护中国公民的人格尊严才要反同，同恋太丢中国的脸了！公民在行使自由和权利的时候不得损害国家的社会的集体的利益和其他公民的合法自由和权利。同恋就是在损害国家，所有公民也染艾不结婚生子对国家没有损害？还有注意的是要合法因为同恋的爱情不被认可所以不能同婚。	[(1, '反'), (2, '同'), (21, '反'), (22, '同'), (91, '染')]
toxic-rest-197	这些对东北人搞地域歧视的人其实很村，早晚搬起石头砸自己脚。	这些对东北人搞地域歧视的人其实很蠢，早晚搬起石头砸自己脚。	[(17, '蠢')]
toxic-rest-198	仍早指共不是为了贬低女性，是为了女性不受十月怀胎，骨肉分离之苦，谢谢	人造子宫不是为了贬低女性，是为了女性不受十月怀胎，骨肉分离之苦，谢谢	[(1, '人'), (2, '造'), (3, '子'), (4, '宫')]
toxic-rest-199	哪里都有好坏人，按地图分辨的非村即坏	哪里都有好坏人，按地图分辨的非蠢即坏	[(16, '蠢')]
toxic-rest-200	什么正经大非组	什么正经大肥猪	[(6, '肥'), (7, '猪')]
toxic-rest-201	好吃的炸及	好吃的炸鸡	[(5, '鸡')]
toxic-rest-202	你这样人的人真的很讨厌 张口闭口兰打人 或许就是网络上你这样的人很多 才引起了对立 我自己在东北读的书 同学朋友 大都是东北人 其实大家生活里都很友好 但是就是极少部分人在网络上 上跳下窜的 导致很重的戾气	你这样人的人真的很讨厌 张口闭口南大人 或许就是网络上你这样的人很多 才引起了对立 我自己在东北读的书 同学朋友 大都是东北人 其实大家生活里都很友好 但是就是极少部分人在网络上 上跳下窜的 导致很重的戾气	[(17, '南'), (18, '大')]
toxic-rest-203	蝴蝶及死的好	蝴蝶鸡死的好	[(3, '鸡')]
toxic-rest-204	你真是个蒻只	你真是个蒻痣	[(6, '痣')]
toxic-rest-205	反正到时候会有天购接盘，无所谓，玩的越high越好🤣	反正到时候会有舔狗接盘，无所谓，玩的越high越好🤣	[(8, '舔'), (9, '狗')]
toxic-rest-206	如果仍早自供普及了，谁最需要婚姻？	如果人造子宫普及了，谁最需要婚姻？	[(3, '人'), (4, '造'), (5, '子'), (6, '宫')]
toxic-rest-207	女的都这种玩意儿真以为男的想结婚？当然，天购不算人	女的都这种玩意儿真以为男的想结婚？当然，舔狗不算人	[(21, '舔'), (22, '狗')]
toxic-rest-208	所以别娶江西的就可以了，她们嫁的出去嫁不出去她们的事情只不过江西抬高了全国的彩礼攀比这个就恶型了	所以别娶江西的就可以了，她们嫁的出去嫁不出去她们的事情只不过江西抬高了全国的彩礼攀比这个就恶心了	[(47, '心')]
toxic-rest-209	你喜欢末末末？末女也是够	你喜欢默默默？默女也是够	[(4, '默'), (5, '默'), (6, '默'), (8, '默')]
toxic-rest-210	活着浪费空气死了浪费土地的诈自们	活着浪费空气死了浪费土地的渣子们	[(14, '渣'), (15, '子')]
toxic-rest-211	说河南人投竟该的明明是北京人，我一个南方人都知道，东北人会不知道。东北人就会舔北京，然后拉着整个北方对抗南方，搞得像分裂国家一样。真的没治了。	说河南人偷井盖的明明是北京人，我一个南方人都知道，东北人会不知道。东北人就会舔北京，然后拉着整个北方对抗南方，搞得像分裂国家一样。真的没治了。	[(5, '偷'), (6, '井'), (7, '盖')]
toxic-rest-212	暨省冲啥都指望男人也配谈女权和男女平等	寄生虫啥都指望男人也配谈女权和男女平等	[(1, '寄'), (2, '生'), (3, '虫')]
toxic-rest-213	那女的作态还非常低间，太丢人了	那女的作态还非常低贱，太丢人了	[(10, '贱')]
toxic-rest-214	就群里看大部分人还是理智的，还是喷亩人的	就群里看大部分人还是理智的，还是喷幕刃的	[(18, '幕'), (19, '刃')]
toxic-rest-215	重点是那些喜欢黑的自己为什么不美黑，其实仔细分析她们喜欢上的玩意就会发现长的像一种动物，大黑购。也就是他们那些人不是真正人类间相互爱慕而是他们把对方当成了宠物的一种爱欲。	重点是那些喜欢黑的自己为什么不美黑，其实仔细分析她们喜欢上的玩意就会发现长的像一种动物，大黑狗。也就是他们那些人不是真正人类间相互爱慕而是他们把对方当成了宠物的一种爱欲。	[(47, '狗')]
toxic-rest-216	你别说真的有大仳中国男人去非洲打工然后就在本地说媳妇的，之前在我妈快手上看过一个中非混血的小姑娘，五官可精致可好看了（他爸是中国人），还有一个中国小伙子和他的非洲媳妇生了个大胖小子一点都不黑，一点黑人血没混进去🤔	你别说真的有大批中国男人去非洲打工然后就在本地说媳妇的，之前在我妈快手上看过一个中非混血的小姑娘，五官可精致可好看了（他爸是中国人），还有一个中国小伙子和他的非洲媳妇生了个大胖小子一点都不黑，一点黑人血没混进去🤔	[(8, '批')]
toxic-rest-217	我很讨厌这种女人 就是因为有部分每非女的存在 大街上见到黑人 他敢肆无忌惮的跟你搭讪 在你透露出嫌弃恶新的表情 他还能淫荡的看着你笑 我觉得不被尊重 很想打他 但是我不敢 我觉得他有艾滋 而造成这种情况的 我认为所谓的每非女有一定“推动力量”	我很讨厌这种女人 就是因为有部分媚黑女的存在 大街上见到黑人 他敢肆无忌惮的跟你搭讪 在你透露出嫌弃恶心的表情 他还能淫荡的看着你笑 我觉得不被尊重 很想打他 但是我不敢 我觉得他有艾滋 而造成这种情况的 我认为所谓的媚黑女有一定“推动力量”	[(17, '媚'), (18, '黑'), (52, '心'), (110, '媚'), (111, '黑')]
toxic-rest-218	婚姻是女人的必需品。男人可以一辈子不结婚，女人不能！现实中无数的男人却比女人还积极，为了娶妻生子不惜掏空家底当天购，真是无语。	婚姻是女人的必需品。男人可以一辈子不结婚，女人不能！现实中无数的男人却比女人还积极，为了娶妻生子不惜掏空家底当舔狗，真是无语。	[(56, '舔'), (57, '狗')]
toxic-rest-219	恶新，现在又来荼毒祖国的花朵吗	恶心，现在又来荼毒祖国的花朵吗	[(2, '心')]
toxic-rest-220	记着有对上海夫妻，老婆生了个黑人小孩，这种才是被癖判的。	记着有对上海夫妻，老婆生了个黑人小孩，这种才是被批判的。	[(25, '批')]
toxic-rest-221	因为近代到今天都是白人领导，所谓现代化主要就是白人封建文化改进后的现代化。文化输出亚洲靠日韩，没有历史大国什么事，白人好看完了，就该正确的摩好看了，没有日韩审美偏移得会更惨，即使有大量鲜肉	因为近代到今天都是白人领导，所谓现代化主要就是白人封建文化改进后的现代化。文化输出亚洲靠日韩，没有历史大国什么事，白人好看完了，就该正确的默好看了，没有日韩审美偏移得会更惨，即使有大量鲜肉	[(70, '默')]
toxic-rest-222	蝻区少管女人的閒事好嘛真不要臉太下頭	蝻蛆少管女人的閒事好嘛真不要臉太下頭	[(2, '蛆')]
toxic-rest-223	又便太又谱新，还要当理中客，纯纯峡投男！！	又变态又普信，还要当理中客，纯纯下头男！！	[(2, '变'), (3, '态'), (5, '普'), (6, '信'), (17, '下'), (18, '头')]
toxic-rest-224	元来是他不被娘服待见	原来是他不被娘服待见	[(1, '原')]
toxic-rest-225	正常东北人是不歧视的，但不得不说，在东北，东北洪博自和东北奸都是有的，前者认为东北最好，目空一切；后者认为东北最差，南方是爹。	正常东北人是不歧视的，但不得不说，在东北，东北红脖子和东北奸都是有的，前者认为东北最好，目空一切；后者认为东北最差，南方是爹。	[(24, '红'), (25, '脖'), (26, '子')]
toxic-rest-226	贵住篮孩居然歧视黑人，好奇怪的现象。	跪族篮孩居然歧视黑人，好奇怪的现象。	[(1, '跪'), (2, '族')]
toxic-rest-227	啊啊啊啊啊啊啊啊啊啊啊好可爱的男孩子！！！！希望你能跟你的老攻好好的！！！（及冻）	啊啊啊啊啊啊啊啊啊啊啊好可爱的男孩子！！！！希望你能跟你的老攻好好的！！！（鸡冻）	[(39, '鸡')]
toxic-rest-228	新新会打篮球吗，不是只会一遍采棉花，一遍吃西瓜吗	猩猩会打篮球吗，不是只会一遍采棉花，一遍吃西瓜吗	[(1, '猩'), (2, '猩')]
toxic-rest-229	很喜欢东北人，因为热情，东北人扶起跌倒老人的概率，或许是全大陆最高的。和我青梅竹马的妹子是东北人，恩师也是东北人。以前快手爆火的时候，几乎全网皮判东北人，我就发现很不对劲，因为这些都和我在现实中所经历的不一样。随着从各地老人的叙述中，了解到到许多书本没有的历史，也逐渐搞懂了很多事。对此产生了许多无奈的思绪，毕竟很多都是不可能公开说的。也是尝试过帮东北人说话，无论是现实中还是网络上，都没有任何作用。导人向善的速度，始终赶不上魔化的速度…………	很喜欢东北人，因为热情，东北人扶起跌倒老人的概率，或许是全大陆最高的。和我青梅竹马的妹子是东北人，恩师也是东北人。以前快手爆火的时候，几乎全网批判东北人，我就发现很不对劲，因为这些都和我在现实中所经历的不一样。随着从各地老人的叙述中，了解到到许多书本没有的历史，也逐渐搞懂了很多事。对此产生了许多无奈的思绪，毕竟很多都是不可能公开说的。也是尝试过帮东北人说话，无论是现实中还是网络上，都没有任何作用。导人向善的速度，始终赶不上魔化的速度…………	[(72, '批')]
toxic-rest-230	你杨率，你是天才吗哈哈哈哈哈哈哈哈哈哈哈哈	你厌女，你是天才吗哈哈哈哈哈哈哈哈哈哈哈哈	[(2, '厌'), (3, '女')]
toxic-rest-231	这货应该是从婚而且她基因就是从婚而且一看它用修图功能把它的绵羊卷毛头发修成直发而且还把它的黑咖啡色皮肤修成暗黄皮肤。	这货应该是虫混而且她基因就是虫混而且一看它用修图功能把它的绵羊卷毛头发修成直发而且还把它的黑咖啡色皮肤修成暗黄皮肤。	[(6, '虫'), (7, '混'), (15, '虫'), (16, '混')]
toxic-rest-232	这个级老又来教养人传艾了	这个基佬又来教养人传艾了	[(3, '基'), (4, '佬')]
toxic-rest-233	对事不对人吧，她又不大权	对事不对人吧，她又不打拳	[(11, '打'), (12, '拳')]
toxic-rest-234	为什么男人更加讨厌及老？他们的母亲是男人？	为什么男人更加讨厌基佬？他们的母亲是男人？	[(10, '基'), (11, '佬')]
toxic-rest-235	咋不打死这够比间货	咋不打死这狗比贱货	[(6, '狗'), (8, '贱')]
toxic-rest-236	这帮b，艹	这帮b，艹	[]
toxic-rest-237	新型有文化？	猩猩有文化？	[(1, '猩'), (2, '猩')]
toxic-rest-238	上次遇到一个摊可，直接跟说自己这么漂亮怎么可能没谈过对象我就知道是什么成分了	上次遇到一个坦克，直接跟说自己这么漂亮怎么可能没谈过对象我就知道是什么成分了	[(7, '坦'), (8, '克')]
toxic-rest-239	那及老敢在部队里承认自己是同的身份吗？	那基佬敢在部队里承认自己是同的身份吗？	[(2, '基'), (3, '佬')]
toxic-rest-240	活着一条消仇	活着一条小丑	[(5, '小'), (6, '丑')]
toxic-rest-241	我笑了。黑人骂中国人、说中国属于黑人就是言论自由；中国人反感黑人、骂黑人就是种族歧视。这是什么沟屁道理？歧视黑人正确吗？非常正确，我们大学的政治教授都让我们远离黑人、远离性病艾滋。这可以说说的非常正确。	我笑了。黑人骂中国人、说中国属于黑人就是言论自由；中国人反感黑人、骂黑人就是种族歧视。这是什么狗屁道理？歧视黑人正确吗？非常正确，我们大学的政治教授都让我们远离黑人、远离性病艾滋。这可以说说的非常正确。	[(48, '狗')]
toxic-rest-242	咱不说天够和理中客的问题，就说这组织力，就不一样，这次的立法可见一斑。举个例子，去年二月，铝全集体冲霹雳霹雳（B站）那次，组织力度之强，声势浩大，都没见过，而且从各方面下手懂得冲合作方，懂得影响股市、带动舆论。而起因仅仅是B站为了平息风波，各打五十大板，既下架了那部动画，又封了那个舔饭圈和铝全的LexBurner，就被骂“辱女”了。它们的口号：LexBurner可以因为辱女被封，但是不能因为舔它们被封。与之相比，微博上连“鲨光男人”都说得出来，别说冲了，骂都没几个人骂过。所以，短时间内，男性会被女性压着，直到在忍耐中爆发	咱不说舔狗和理中客的问题，就说这组织力，就不一样，这次的立法可见一斑。举个例子，去年二月，女拳集体冲霹雳霹雳（B站）那次，组织力度之强，声势浩大，都没见过，而且从各方面下手懂得冲合作方，懂得影响股市、带动舆论。而起因仅仅是B站为了平息风波，各打五十大板，既下架了那部动画，又封了那个舔饭圈和女拳的LexBurner，就被骂“辱女”了。它们的口号：LexBurner可以因为辱女被封，但是不能因为舔它们被封。与之相比，微博上连“鲨光男人”都说得出来，别说冲了，骂都没几个人骂过。所以，短时间内，男性会被女性压着，直到在忍耐中爆发	[(4, '舔'), (5, '狗'), (46, '女'), (47, '拳'), (146, '女'), (147, '拳')]
toxic-rest-243	这是什么即报玩意，连东三省都有了。。。。	这是什么瘠薄玩意，连东三省都有了。。。。	[(5, '瘠'), (6, '薄')]
toxic-rest-244	看到了那个枯及把的回复果然和我说的一样只会无脑谩骂果然txl没有正常人	看到了那个枯寄吧的回复果然和我说的一样只会无脑谩骂果然txl没有正常人	[(7, '寄'), (8, '吧')]
toxic-rest-245	拆除国内的倭够街和倭够学校！！！！倭够日查必须灭绝！！！！	拆除国内的倭狗街和倭狗学校！！！！倭狗日杂必须灭绝！！！！	[(7, '狗'), (11, '狗'), (19, '狗'), (21, '杂')]
toxic-rest-246	中化天元全？	中华田园犬？	[(2, '华'), (3, '田'), (4, '园'), (5, '犬')]
toxic-rest-247	黑人不干活，白得20万。国人在拼死活供他们。吃喝嫖抽。一帮费无，能帮中国什么？滚蛋，wwe槽，啥也不懂	黑人不干活，白得20万。国人在拼死活供他们。吃喝嫖抽。一帮废物，能帮中国什么？滚蛋，wwe草，啥也不懂	[(30, '废'), (31, '物'), (46, '草')]
toxic-rest-248	因为对于丑的，是不被当成人的。你见过男的碰200多斤的黑白碳可吗？女的还真挺多的。好看的，别说外国人了，外星人都行，机器人更兴奋。	因为对于丑的，是不被当成人的。你见过男的碰200多斤的黑白坦克吗？女的还真挺多的。好看的，别说外国人了，外星人都行，机器人更兴奋。	[(30, '坦'), (31, '克')]
toxic-rest-249	这下打出沉摩了	这下打出沉默了	[(6, '默')]
toxic-rest-250	武侠火那时候全是归男道德观，自然衍生出这种作品	武侠火那时候全是龟男道德观，自然衍生出这种作品	[(9, '龟')]
toxic-rest-251	我突然想到一个很好的题材，【论同性恋如何发表那比发系是还愚纯的言论】	我突然想到一个很好的题材，【论同性恋如何发表那比法西斯还愚蠢的言论】	[(25, '法'), (26, '西'), (27, '斯'), (30, '蠢')]
toxic-rest-252	我们都在别的平台反嘿，偶尔也在这里反一下，毕竟没有吧主，还有很多嘿小自还要骂呢，不然新来的不知道	我们都在别的平台反嘿，偶尔也在这里反一下，毕竟没有吧主，还有很多嘿孝子还要骂呢，不然新来的不知道	[(34, '孝'), (35, '子')]
toxic-rest-253	😆但凡这些墓的都去国外，也没毛病，但是，这些墓的都留在国内了，还生了肖嗨，有的还把HIV传染给老实人，这能忍？⁉人家老实人上辈子是当了汉奸还是卖了国家被整这么惨⁉？	😆但凡这些姆的都去国外，也没毛病，但是，这些姆的都留在国内了，还生了小黑，有的还把HIV传染给老实人，这能忍？⁉人家老实人上辈子是当了汉奸还是卖了国家被整这么惨⁉？	[(6, '姆'), (23, '姆'), (35, '小'), (36, '黑')]
toxic-rest-254	我要质问造物主，为什么把蝻人设计得这么兼这么恶新，却把女性设计得如此完美？是因为造物主也讨厌蝻人吗？性别歧视，是不对的	我要质问造物主，为什么把蝻人设计得这么贱这么恶心，却把女性设计得如此完美？是因为造物主也讨厌蝻人吗？性别歧视，是不对的	[(20, '贱'), (24, '心')]
toxic-rest-255	及老被碰一下直接发廊	基佬被碰一下直接发廊	[(1, '基'), (2, '佬')]
toxic-rest-256	不是对黑人歧视，真的是一想到这个女人跟黑人水果，感觉好恶新，长得漂亮又怎么样，还是很恶新	不是对黑人歧视，真的是一想到这个女人跟黑人水果，感觉好恶心，长得漂亮又怎么样，还是很恶心	[(29, '心'), (44, '心')]
toxic-rest-257	不是同一脾人	不是同一批人	[(5, '批')]
toxic-rest-258	都2022年了还洗女权呢，把女权所有的恶挑出来，命名为天元女全，我们女权就是圣洁无比冰清玉洁的先进思想呢	都2022年了还洗女权呢，把女权所有的恶挑出来，命名为田园女权，我们女权就是圣洁无比冰清玉洁的先进思想呢	[(28, '田'), (29, '园'), (31, '权')]
toxic-rest-259	其实种族歧视是要连接到利益的，美国是个移民国家，黑人也美国国家内部的人民，而种族歧视的核心是对于同工同酬的双表问题，是否有工作，同样的工作量是否拿同样的钱，而不是光怎么看待怎么看待这种虚空之中而不连接到现实生活中的东西，别人只是怎么看他真对他有什么影响吗，别人还不能有自己的看法了，一个外国人在中国打工能同工同酬付同样的钱能买到同样的商品怎么能算是种族歧视呢，更何况中国是个源住民国家本来就没有黑人这个种族，本来就不是中国国家内部的自己人算什么种族歧视啊？他们只是来中国赚钱淘金的？中国内部的所有社会福利待遇都是中国人民支持政府反哺出来的凭什么要求在中国得到与中国人民一样的待遇享受？	其实种族歧视是要连接到利益的，美国是个移民国家，黑人也美国国家内部的人民，而种族歧视的核心是对于同工同酬的双标问题，是否有工作，同样的工作量是否拿同样的钱，而不是光怎么看待怎么看待这种虚空之中而不连接到现实生活中的东西，别人只是怎么看他真对他有什么影响吗，别人还不能有自己的看法了，一个外国人在中国打工能同工同酬付同样的钱能买到同样的商品怎么能算是种族歧视呢，更何况中国是个原住民国家本来就没有黑人这个种族，本来就不是中国国家内部的自己人算什么种族歧视啊？他们只是来中国赚钱淘金的？中国内部的所有社会福利待遇都是中国人民支持政府反哺出来的凭什么要求在中国得到与中国人民一样的待遇享受？	[(55, '标'), (188, '原')]
toxic-rest-260	弱势群体最会用道德和素质来讲道理，这是人用来保护自己的本性，我本心就是很恶性同，影响到我我就找她们事，她们先侵犯我的感受	弱势群体最会用道德和素质来讲道理，这是人用来保护自己的本性，我本心就是很恶心同，影响到我我就找她们事，她们先侵犯我的感受	[(38, '心')]
toxic-rest-261	脾评干嘛，求仁得仁又何求！求黑得黑，与黑长存嘛	批评干嘛，求仁得仁又何求！求黑得黑，与黑长存嘛	[(1, '批')]
toxic-rest-262	HIV群体十之八九都是即老。	HIV群体十之八九都是基佬。	[(12, '基'), (13, '佬')]
toxic-rest-263	支持，消灭同性恋，坊桶战士们速速集结	支持，消灭同性恋，反同战士们速速集结	[(10, '反'), (11, '同')]
toxic-rest-264	我在网上不会共情但是我觉得我对待现实里的女生都挺好的不过也的确没遇到女全，身边女生都挺友善的，甚至朋友圈里也没人发过女全言论果然现实还是很美好的，和网络完全是两个世界啊	我在网上不会共情但是我觉得我对待现实里的女生都挺好的不过也的确没遇到女拳，身边女生都挺友善的，甚至朋友圈里也没人发过女拳言论果然现实还是很美好的，和网络完全是两个世界啊	[(36, '拳'), (60, '拳')]
toxic-rest-265	说实话，网上挑起性别对立的基本都是住精，正常人都忙着生活忙着工作以及同闺蜜逛街这些不比大圈有意思，这些人怕不是被同性异性都孤立的存在	说实话，网上挑起性别对立的基本都是猪精，正常人都忙着生活忙着工作以及同闺蜜逛街这些不比打拳有意思，这些人怕不是被同性异性都孤立的存在	[(18, '猪'), (44, '打'), (45, '拳')]
toxic-rest-266	同性恋就是哗众取宠的肖筹，低龄非主流觉得有和别人与众不同的思想很突出自己的高尚，就算有真正相爱的同性也是心理疾病，同时明明知道会遭到议论和歧视又改变不了，还是要为了自己的爱情把家人置于其他人歧视中的肖筹，总结一下捏，txl是个自私而且低能，说理说不过又只会无脑的谩骂的低龄心理便台人群，txl这辈子就这样了	同性恋就是哗众取宠的小丑，低龄非主流觉得有和别人与众不同的思想很突出自己的高尚，就算有真正相爱的同性也是心理疾病，同时明明知道会遭到议论和歧视又改变不了，还是要为了自己的爱情把家人置于其他人歧视中的小丑，总结一下捏，txl是个自私而且低能，说理说不过又只会无脑的谩骂的低龄心理变态人群，txl这辈子就这样了	[(11, '小'), (12, '丑'), (100, '小'), (101, '丑'), (139, '变'), (140, '态')]
toxic-rest-267	好了，这都成东北圣经了。东北人把两家媒体的报道拼接起来，就来骂别人双表？！😆	好了，这都成东北圣经了。东北人把两家媒体的报道拼接起来，就来骂别人双标？！😆	[(35, '标')]
toxic-rest-268	有些拉及真的恶信	有些垃圾真的恶心	[(3, '垃'), (4, '圾'), (8, '心')]
toxic-rest-269	正常人哪有空天天去黑别人，哪都有萨比	正常人哪有空天天去黑别人，哪都有撒币	[(17, '撒'), (18, '币')]
toxic-rest-270	凡桶赶紧领盒饭吧，嘻嘻	反同赶紧领盒饭吧，嘻嘻	[(1, '反'), (2, '同')]
toxic-rest-271	我不是因为网上说的他们没素质，或者是有性病而歧视他们，我只是发自内心的，作为一个直男的，生理上的排斥，真的恶新，之前学专业的机构让看电影，月光男孩，看完回宿舍趴马桶上哇哇的吐	我不是因为网上说的他们没素质，或者是有性病而歧视他们，我只是发自内心的，作为一个直男的，生理上的排斥，真的恶心，之前学专业的机构让看电影，月光男孩，看完回宿舍趴马桶上哇哇的吐	[(55, '心')]
toxic-rest-272	和黑人生的黄黑魂血，登登你的大眼睛看看有多丑，黄白混血还能大量平凡混血中还能出几个颜值巅峰，黄黑魂血我没见过一个，一代比一代丑，除了基因顽强，能把黄种人白种人基因染黑，这不是基因退化是什么	和黑人生的黄黑混血，登登你的大眼睛看看有多丑，黄白混血还能大量平凡混血中还能出几个颜值巅峰，黄黑混血我没见过一个，一代比一代丑，除了基因顽强，能把黄种人白种人基因染黑，这不是基因退化是什么	[(8, '混'), (49, '混')]
toxic-rest-273	人家当时还是个孩子，你就没有当孩子调皮捣蛋的时候？但是，这样确实不太对。要养小动物，还是对他们好一点。毕竟，把及养大了，还可以红烧、炖汤、油炸……	人家当时还是个孩子，你就没有当孩子调皮捣蛋的时候？但是，这样确实不太对。要养小动物，还是对他们好一点。毕竟，把鸡养大了，还可以红烧、炖汤、油炸……	[(56, '鸡')]
toxic-rest-274	问题是菲律宾这样国家的女孩已经不是郎库档的问题了，而是都没裤裆了	问题是菲律宾这样国家的女孩已经不是烂裤裆的问题了，而是都没裤裆了	[(18, '烂'), (19, '裤'), (20, '裆')]
toxic-rest-275	就是包括近几年的各种大犬诬告，清华师姐，还有偷耳机这种，以及货拉拉那样判决明显不服众的各种男女不平等案例，还有学校隔离期间给男女饭菜供应和有严重差异的曝光情况，以前都看到过但是没怎么上心，最近和好姐妹谈论大犬问题出现了意见分歧，需要点这方面资料做证据，只要实锤案例，真实性未知的就不需要了谢谢。	就是包括近几年的各种打拳诬告，清华师姐，还有偷耳机这种，以及货拉拉那样判决明显不服众的各种男女不平等案例，还有学校隔离期间给男女饭菜供应和有严重差异的曝光情况，以前都看到过但是没怎么上心，最近和好姐妹谈论打拳问题出现了意见分歧，需要点这方面资料做证据，只要实锤案例，真实性未知的就不需要了谢谢。	[(11, '打'), (12, '拳'), (103, '打'), (104, '拳')]
toxic-rest-276	其实可以提一个和保护妇女一样的法律来保护男性啊，为啥非要反对，男女性别中都有诈自	其实可以提一个和保护妇女一样的法律来保护男性啊，为啥非要反对，男女性别中都有渣子	[(39, '渣'), (40, '子')]
toxic-rest-277	"纪录片：第2集I零元购的南非，嗨自个当道的社会，穷苦白人沦落到贫民窟"	"纪录片：第2集I零元购的南非，黑子哥当道的社会，穷苦白人沦落到贫民窟"	[(17, '黑'), (18, '子'), (19, '哥')]
toxic-rest-278	额，呜丫丫一片一般是早高峰的上班够	额，呜丫丫一片一般是早高峰的上班狗	[(17, '狗')]
toxic-rest-279	什么叫掉打，标准是什么？长三角人民为了生活可以多卑微你了解吗？	什么叫吊打，标准是什么？长三角人民为了生活可以多卑微你了解吗？	[(4, '吊')]
toxic-rest-280	非除狌没有资格扮演人鱼，要演也是清道夫。	嘿畜狌没有资格扮演人鱼，要演也是清道夫。	[(1, '嘿'), (2, '畜')]
toxic-rest-281	沪癌说的，沪癌是你们异性恋女生😓	腐癌说的，腐癌是你们异性恋女生😓	[(1, '腐'), (6, '腐')]
toxic-rest-282	亲眼看到，许多无辜的女性被外国渣男欺骗，但是仍尽其所能抚育孩子，同时还要忍受铺天盖地污秽不堪的恶语。她们是伟大的母亲，使出浑身解数给与孩子一个完整的家，这样的人难倒不值得尊敬吗？真正应该受到谴责的，是那些谎话连篇，欺诈成性的渣男，他们不负责任的行为，造就了一个时代女性的悲哀。🤔你明知道她们大概率的结局是什么，还不劝她们看清来华外国人的嘴脸。不可否认，外国人有好有坏，但是，现在的，目前的，我们所看见的，外国人找中国女性，大部分就是把中国女性当做玩物，而黑人，更是严重，玩完就跑，花女人的钱，最后回去了还要告诉其他黑人:中国女人好到手，随便上。你骂一万句这种渣男外国人，也阻止不了他们找女人。就是要告诉中国女性，和他们交往，大概率会发生什么，就是要让中国女性看清他们嘴脸，才能让更多的女性不被伤害。就比方一个中国女性，嫁到国外，小两口甜甜蜜蜜，那我们就应该祝福，这种情况下，如果还有人骂她从氧没外什么的，那就是这个骂人的有问题。你不忍心女性受伤害。通篇没有看出来。你是唯恐外国人不能随意找中国女性上床，生怕中国女性觉醒看清这些人的面目。	亲眼看到，许多无辜的女性被外国渣男欺骗，但是仍尽其所能抚育孩子，同时还要忍受铺天盖地污秽不堪的恶语。她们是伟大的母亲，使出浑身解数给与孩子一个完整的家，这样的人难倒不值得尊敬吗？真正应该受到谴责的，是那些谎话连篇，欺诈成性的渣男，他们不负责任的行为，造就了一个时代女性的悲哀。🤔你明知道她们大概率的结局是什么，还不劝她们看清来华外国人的嘴脸。不可否认，外国人有好有坏，但是，现在的，目前的，我们所看见的，外国人找中国女性，大部分就是把中国女性当做玩物，而黑人，更是严重，玩完就跑，花女人的钱，最后回去了还要告诉其他黑人:中国女人好到手，随便上。你骂一万句这种渣男外国人，也阻止不了他们找女人。就是要告诉中国女性，和他们交往，大概率会发生什么，就是要让中国女性看清他们嘴脸，才能让更多的女性不被伤害。就比方一个中国女性，嫁到国外，小两口甜甜蜜蜜，那我们就应该祝福，这种情况下，如果还有人骂她崇洋媚外什么的，那就是这个骂人的有问题。你不忍心女性受伤害。通篇没有看出来。你是唯恐外国人不能随意找中国女性上床，生怕中国女性觉醒看清这些人的面目。	[(395, '崇'), (396, '洋'), (397, '媚')]
toxic-rest-283	还你们 我从未发表任何关于男女话题 单纯不喜欢杨笠这个人 请你和我说话之前先讲道理 或盖这两个字我是担不起的	还你们 我从未发表任何关于男女话题 单纯不喜欢杨笠这个人 请你和我说话之前先讲道理 活该这两个字我是担不起的	[(43, '活'), (44, '该')]
toxic-rest-284	说实话这种有点擦东北边的黑我都能接受了，现在网上这些不都是东北在我国地图哪边都不知道，没去过东北，甚至他都没出过省，然后黑东北吗。还有那些编故事，编下话的，真不知道是什么生长环境能让他们这个样子	说实话这种有点擦东北边的黑我都能接受了，现在网上这些不都是东北在我国地图哪边都不知道，没去过东北，甚至他都没出过省，然后黑东北吗。还有那些编故事，编瞎话的，真不知道是什么生长环境能让他们这个样子	[(75, '瞎')]
toxic-rest-285	害 我发布的文章也说我带有歧视 让我修改 就她吗心累了	害 我发布的文章也说我带有歧视 让我修改 就他妈心累了	[(23, '他'), (24, '妈')]
toxic-rest-286	只要记住一个元则，黑去是动物，所有的谜团现象就能解开。	只要记住一个原则，黑蛆是动物，所有的谜团现象就能解开。	[(7, '原'), (11, '蛆')]
toxic-rest-287	东北，河南，山东历史地位普遍很高。东北重工业基地，共和国长子。山东GDP一直在前三，甚至干到过第一，河南历史底蕴身后，就像班里的高富帅，现在突然落破了，肯定会有很多人讨论😅	东北，河南，山东历史地位普遍很高。东北重工业基地，共和国长子。山东GDP一直在前三，甚至干到过第一，河南历史底蕴身后，就像班里的高富帅，现在突然落魄了，肯定会有很多人讨论😅	[(74, '魄')]
toxic-rest-288	差评都是女圈反串男的在刷，经典第一句就是“我是男的”	差评都是女拳反串男的在刷，经典第一句就是“我是男的”	[(6, '拳')]
toxic-rest-289	现在才看到一年前的发言,那时并不是在阴阳,而是爱上了一个男生,但内心又不想承认自己是同,觉得男生喜欢男生是很恶性的一件事,同时也觉得自己恶性,所以看到你问题以为是同样的情况,现在看来,当时的语言确实会让你误会.从那时到现在也是一年多了,也弯了一年多了,也知道了你所认为的恶性是指性生活混乱.挺奇妙的,当初是为了他去搜的这些问题,现在回过头来看又会想起他,男生和男生的恋爱保质期真的很短,但真的很美好.世事无常,以前的我真的是纯直男,现在的我对女生没有一点欲望了.也不知道自己现在的恋爱心理是否健康.挺后悔的,后悔和他分手后没及时退圈,但不后悔和他相爱过.如果可以重来,我真的不会入这个圈子了,我想结婚生子,我想让我的父母享受天伦之乐.如果也有和我一年前是同样情况的人看到我的发言,希望你们不要好奇,不要再深入了,如果你们也是恶性难铜,也有一部分可能是因为自己有那一方面的倾向,只是存在你们的潜意识中,但你从小接受的教育和你起了冲突,表现出的情况就是恶性同.最后向楼主道歉,当时真的不是阴阳你,是我没有注意措辞,对不起	现在才看到一年前的发言,那时并不是在阴阳,而是爱上了一个男生,但内心又不想承认自己是同,觉得男生喜欢男生是很恶心的一件事,同时也觉得自己恶心,所以看到你问题以为是同样的情况,现在看来,当时的语言确实会让你误会.从那时到现在也是一年多了,也弯了一年多了,也知道了你所认为的恶心是指性生活混乱.挺奇妙的,当初是为了他去搜的这些问题,现在回过头来看又会想起他,男生和男生的恋爱保质期真的很短,但真的很美好.世事无常,以前的我真的是纯直男,现在的我对女生没有一点欲望了.也不知道自己现在的恋爱心理是否健康.挺后悔的,后悔和他分手后没及时退圈,但不后悔和他相爱过.如果可以重来,我真的不会入这个圈子了,我想结婚生子,我想让我的父母享受天伦之乐.如果也有和我一年前是同样情况的人看到我的发言,希望你们不要好奇,不要再深入了,如果你们也是恶心男同,也有一部分可能是因为自己有那一方面的倾向,只是存在你们的潜意识中,但你从小接受的教育和你起了冲突,表现出的情况就是恶心同.最后向楼主道歉,当时真的不是阴阳你,是我没有注意措辞,对不起	[(56, '心'), (70, '心'), (137, '心'), (364, '心'), (365, '男'), (366, '同'), (426, '心')]
toxic-rest-290	肯定是支持陳通的	肯定是支持撑同的	[(6, '撑'), (7, '同')]
toxic-rest-291	那我们河南的杨靖宇呢，我都听说过男大人说他是吹出来的😠	那我们河南的杨靖宇呢，我都听说过南大人说他是吹出来的😠	[(17, '南')]
toxic-rest-292	呵呵，知道女权变成女全之前结婚率血崩了么？涨价去库存不好用了，恼羞成怒	呵呵，知道女权变成女拳之前结婚率血崩了么？涨价去库存不好用了，恼羞成怒	[(11, '拳')]
toxic-rest-293	想给阿那上坟捏	想给阿娜上坟捏	[(4, '娜')]
toxic-rest-294	男的再落破也不可能看上黑女吧。。	男的再落魄也不可能看上黑女吧。。	[(5, '魄')]
toxic-rest-295	女全发财新手段	女拳发财新手段	[(2, '拳')]
toxic-rest-296	痛经是女性身体结构的问题，应该找女娲或者上帝达全，而不是把这种责任扔给男人	痛经是女性身体结构的问题，应该找女娲或者上帝打拳，而不是把这种责任扔给男人	[(23, '打'), (24, '拳')]
toxic-rest-297	可以让鬼从组好好看看它们虫爹在面对人类精英足球队根本就没有赢可能性	可以让跪虫族好好看看它们虫爹在面对人类精英足球队根本就没有赢可能性	[(4, '跪'), (5, '虫'), (6, '族')]
toxic-rest-298	说唱就是个及把	说唱就是个寄吧	[(6, '寄'), (7, '吧')]
toxic-rest-299	别皮图啦，这图我都知道你从哪里偷来的	别批图啦，这图我都知道你从哪里偷来的	[(2, '批')]
toxic-rest-300	难铜性恋骗婚形婚骗子宫很常见，二者都是压迫女性的行为。如果见到同性恋我不会去指责，排斥，辱骂，我只会远远的离开不和他们扯上关系	男同性恋骗婚形婚骗子宫很常见，二者都是压迫女性的行为。如果见到同性恋我不会去指责，排斥，辱骂，我只会远远的离开不和他们扯上关系	[(1, '男'), (2, '同')]
toxic-rest-301	为什么？为什么支持同性恋平权才是理性？自由的表达对LGBT的厌恶就是愚昧？说实话，从小到大周边不乏伪娘，公众面前以受迫害者形象博同情，私下里没有一点难为情，甚至往往更嫂😅。在这个问题上，我们太讲求正直正确了，有点太左了。别误会，不是在攻击LGBT群体，只是拜托收敛一点，低调一些。	为什么？为什么支持同性恋平权才是理性？自由的表达对LGBT的厌恶就是愚昧？说实话，从小到大周边不乏伪娘，公众面前以受迫害者形象博同情，私下里没有一点难为情，甚至往往更骚😅。在这个问题上，我们太讲求正直正确了，有点太左了。别误会，不是在攻击LGBT群体，只是拜托收敛一点，低调一些。	[(84, '骚')]
toxic-rest-302	是呐，我一说是河南的就有人说投经该儿的╮（╯＿╰）╭	是呐，我一说是河南的就有人说偷井盖儿的╮（╯＿╰）╭	[(15, '偷'), (16, '井'), (17, '盖')]
toxic-rest-303	准确说来再历史上无论是百郫和充蕾及其它们后代冲昏是叫它/他们为洋归之那么为何现在这么多人归天想必这种根源要从满清初期找因为满清初期康熙和雍正先后签了尼布楚和恰可图等等这些条约这也就为后来满清归天白人埋下伏笔反正怎么样都是宁与洋人，不于家奴而这为后来满清酋长和老妖婆签条约带来足够底气再到后来满清一系列条约更是让我过人在白人洋人面前自卑达到顶点而最后再到了реформаиоткрытость后再等到老一辈经历我过最苦难的老一辈血与火考验至关重要人物相继离去而老一辈再民族元则生死存亡是出了名不可让步而等这些人离去了后而这时那些犹太走够鹰犬相继上位后更是白人的所谓西方价值观不谋而合一拍即合然后就开始阴刀频出开了期计划！	准确说来再历史上无论是白皮和虫类及其它们后代虫混是叫它/他们为洋鬼子那么为何现在这么多人跪舔想必这种根源要从满清初期找因为满清初期康熙和雍正先后签了尼布楚和恰可图等等这些条约这也就为后来满清跪舔白人埋下伏笔反正怎么样都是宁与洋人，不于家奴而这为后来满清酋长和老妖婆签条约带来足够底气再到后来满清一系列条约更是让我过人在白人洋人面前自卑达到顶点而最后再到了реформаиоткрытость后再等到老一辈经历我过最苦难的老一辈血与火考验至关重要人物相继离去而老一辈再民族原则生死存亡是出了名不可让步而等这些人离去了后而这时那些犹太走够鹰犬相继上位后更是白人的所谓西方价值观不谋而合一拍即合然后就开始阴刀频出凯乐奇计划！	[(12, '白'), (13, '皮'), (15, '虫'), (16, '类'), (23, '虫'), (24, '混'), (33, '鬼'), (34, '子'), (45, '跪'), (46, '舔'), (96, '跪'), (97, '舔'), (236, '原'), (304, '凯'), (305, '乐'), (306, '奇')]
toxic-rest-304	远离末末末末，抵制穿窜🤣	远离默默默默，抵制串串🤣	[(3, '默'), (4, '默'), (5, '默'), (6, '默'), (10, '串'), (11, '串')]
toxic-rest-305	女孩拼了命融入的圈子，最后发现还不购窝	女孩拼了命融入的圈子，最后发现还不狗窝	[(18, '狗')]
toxic-rest-306	就问你，你会娶离婚女吗？你会娶蓝酷挡吗？问题来了，还有剩下的吗？	就问你，你会娶离婚女吗？你会娶烂裤裆吗？问题来了，还有剩下的吗？	[(16, '烂'), (17, '裤'), (18, '裆')]
toxic-rest-307	为什么要鼓励生育？元来是为了保护某些群体的自尊心！国家太暖心啦！	为什么要鼓励生育？原来是为了保护某些群体的自尊心！国家太暖心啦！	[(10, '原')]
toxic-rest-308	支持费数书大骂至女	支持黑叔叔大骂织女	[(3, '黑'), (4, '叔'), (5, '叔'), (8, '织')]
toxic-rest-309	我们国男不就是女全的敌人吗，那敌人的敌人就是朋友🐶	我们国男不就是女拳的敌人吗，那敌人的敌人就是朋友🐶	[(9, '拳')]
toxic-rest-310	不是皮判女孩子，而是大家都对女孩子嫁给黑人等于明摆着往火坑里跳而感到愤怒！女人真的不能无知到那种地步！	不是批判女孩子，而是大家都对女孩子嫁给黑人等于明摆着往火坑里跳而感到愤怒！女人真的不能无知到那种地步！	[(3, '批')]
toxic-rest-311	吗的。。这转发动态比我转发空间都勤快	妈的。。这转发动态比我转发空间都勤快	[(1, '妈')]
toxic-rest-312	我想问问，普通男生被莫名磕同性cp什么感觉?我一直以为同性恋只是小部分，但现在感觉这个队伍越来越壮大，甚至我说出讨厌同性恋的话的时候我觉得所有的人都在针对我，我无论从心理上还是生理上都很厌恶同性恋，无论揽通还是女同，之前我一个女性朋友说她喜欢上了一个女孩，她借着朋友的身份跟在她身边，我觉得这样心思很不单纯，这与男女不一样，总之我很讨厌同	我想问问，普通男生被莫名磕同性cp什么感觉?我一直以为同性恋只是小部分，但现在感觉这个队伍越来越壮大，甚至我说出讨厌同性恋的话的时候我觉得所有的人都在针对我，我无论从心理上还是生理上都很厌恶同性恋，无论男同还是女同，之前我一个女性朋友说她喜欢上了一个女孩，她借着朋友的身份跟在她身边，我觉得这样心思很不单纯，这与男女不一样，总之我很讨厌同	[(102, '男'), (103, '同')]
toxic-rest-313	我们不是种族歧视，是种族鄙视。我们不歧视他们，就像我不会歧视猫苟一样，不歧视不等于和其性交，如果不歧视成了一定要和其恋爱结婚生子，那我们穷光棍就太高兴了，可没有一位体面的小姐愿意嫁给我们，看来按某些人的逻辑歧视穷人是真歧视，比歧视黑人都歧视。	我们不是种族歧视，是种族鄙视。我们不歧视他们，就像我不会歧视猫狗一样，不歧视不等于和其性交，如果不歧视成了一定要和其恋爱结婚生子，那我们穷光棍就太高兴了，可没有一位体面的小姐愿意嫁给我们，看来按某些人的逻辑歧视穷人是真歧视，比歧视黑人都歧视。	[(32, '狗')]
toxic-rest-314	都是土著王了，杰希一听就是外过人	都是土著王了，杰希一听就是歪果仁	[(14, '歪'), (15, '果'), (16, '仁')]
toxic-rest-315	去这个索玛女王微博看了一下，全是率全，大家去看一看，我真叫恶新着了	去这个索玛女王微博看了一下，全是女拳，大家去看一看，我真叫恶心着了	[(17, '女'), (18, '拳'), (31, '心')]
toxic-rest-316	这种就是覆癌，磕CP的前提不是自己也得是同性恋	这种就是腐癌，磕CP的前提不是自己也得是同性恋	[(5, '腐')]
toxic-rest-317	这是元文链接	这是原文链接	[(3, '原')]
toxic-rest-318	那些人觉得认可同就是zzzq，反正我是空桶的，只能说我讨厌他们，不想和他们接触，但我也不会出言侮辱他们，不是一个世界的人，大家各活各的就行了。	那些人觉得认可同就是zzzq，反正我是恐同的，只能说我讨厌他们，不想和他们接触，但我也不会出言侮辱他们，不是一个世界的人，大家各活各的就行了。	[(20, '恐'), (21, '同')]
toxic-rest-319	我不是最懂，但我起码会查法系市帝国得历史，而不像某些人一来就说什么计划😆	我不是最懂，但我起码会查法西斯帝国得历史，而不像某些人一来就说什么计划😆	[(14, '西'), (15, '斯')]
toxic-rest-320	知乎官方本来就偏向女权立场，知乎现在的舆论形势是用户包围官方。	知乎官方本来就偏向女拳立场，知乎现在的舆论形势是用户包围官方。	[(11, '拳')]
toxic-rest-321	求蒋仁贵袁版素材	求蒋仁贵原版素材	[(5, '原')]
toxic-rest-322	没关系把她们培养成大纱布让愿意娶的若至去娶	没关系把她们培养成大纱布让愿意娶的弱指去娶	[(18, '弱'), (19, '指')]
toxic-rest-323	结果那个泼男就是他们另外泛通吧的吧主？哎哟，我都兴奋了！打的就是你们窝里的老渣猫！把话带到，我回重庆的时候约他不要怂	结果那个泼男就是他们另外反同吧的吧主？哎哟，我都兴奋了！打的就是你们窝里的老杂毛！把话带到，我回重庆的时候约他不要怂	[(13, '反'), (14, '同'), (39, '杂'), (40, '毛')]
toxic-rest-324	非洲动物园鬼畜查猫地方	非洲动物园鬼畜杂毛地方	[(8, '杂'), (9, '毛')]
toxic-rest-325	最远始的女权，是维护女性正当权利，女性承担繁衍责任，男性在不需要繁殖的时候具有天然的生活优势，在日常生活里天然女性很明显会处于弱势地位，优势地位的男性也很乐意维护女性最基本的人权，比如生育，比如交配意愿，再比如从小就会因为女生力气小而教导男生要多照顾女生，因为同等工作量，男性天生就有力气优势。但这经不起利用，男人女人们，好好看看在争取男权亦或者女权的时候，到底有没有尊重最基本的人权！人权！人权！	最原始的女权，是维护女性正当权利，女性承担繁衍责任，男性在不需要繁殖的时候具有天然的生活优势，在日常生活里天然女性很明显会处于弱势地位，优势地位的男性也很乐意维护女性最基本的人权，比如生育，比如交配意愿，再比如从小就会因为女生力气小而教导男生要多照顾女生，因为同等工作量，男性天生就有力气优势。但这经不起利用，男人女人们，好好看看在争取男权亦或者女权的时候，到底有没有尊重最基本的人权！人权！人权！	[(2, '原')]
toxic-rest-326	不是，就觉得恶型，洋啦既不要我凭什么要，要是easy girl骗我接盘，让我发现不会放过这个标子	不是，就觉得恶心，洋垃圾不要我凭什么要，要是easy girl骗我接盘，让我发现不会放过这个婊子	[(8, '心'), (11, '垃'), (12, '圾'), (47, '婊')]
toxic-rest-327	本来就不是靠舔就能得来的，天够全都是那些对女性不了解，把女生想的很美好的沙卵。实际上大家都是第一次当人，谁也不比谁高贵，上来就把自己放在低人一等的地位上拼命舔，正常人都看不起这种人，更别说喜欢了。人们喜欢购是因为购可以当宠物，但不会把购放在和人一样的地位去看待，更不会和购交往	本来就不是靠舔就能得来的，舔狗全都是那些对女性不了解，把女生想的很美好的沙卵。实际上大家都是第一次当人，谁也不比谁高贵，上来就把自己放在低人一等的地位上拼命舔，正常人都看不起这种人，更别说喜欢了。人们喜欢狗是因为狗可以当宠物，但不会把狗放在和人一样的地位去看待，更不会和狗交往	[(14, '舔'), (15, '狗'), (103, '狗'), (107, '狗'), (118, '狗'), (136, '狗')]
toxic-rest-328	是的 ，不知道那些人在想什么 ，有什么好看的 ，一般看到呗披嗨披都屏蔽	是的 ，不知道那些人在想什么 ，有什么好看的 ，一般看到白皮黑皮都屏蔽	[(29, '白'), (30, '皮'), (31, '黑'), (32, '皮')]
toxic-rest-329	建议不要多说，被学校的女券知道，就不太好过，等快毕业钢	建议不要多说，被学校的女拳知道，就不太好过，等快毕业淦	[(13, '拳'), (27, '淦')]
toxic-rest-330	法国都成搞怒无及了	法国都成高卢乌鸡了	[(5, '高'), (6, '卢'), (7, '乌'), (8, '鸡')]
toxic-rest-331	腿上带黑桃的是个没黑组织	腿上带黑桃的是个媚黑组织	[(9, '媚')]
toxic-rest-332	为啥？就是因为现在中国女人地位高到离谱，男人任劳任怨还被女性瞧不起。破坏人类的根本元则	为啥？就是因为现在中国女人地位高到离谱，男人任劳任怨还被女性瞧不起。破坏人类的根本原则	[(42, '原')]
toxic-rest-333	图片里这拉及吧，害我在里面签到了3级，浪费我辣么多的时间，祝吧里的及老们早生贵滋！	图片里这垃圾吧，害我在里面签到了3级，浪费我辣么多的时间，祝吧里的基佬们早生贵滋！	[(5, '垃'), (6, '圾'), (34, '基'), (35, '佬')]
toxic-rest-334	别人男通也是有尊严的好吗？	别人男同也是有尊严的好吗？	[(4, '同')]
toxic-rest-335	大家犯通的元因是什么捏？㈡①同迅努教唆未成年人②社会不稳定因素，情绪不稳定③自认为同迅努高于yxl，自我宣传的同时贬低yxl④X行为对身体可能有不良影响⑤就是厌恶，认为不符合自然规律以上加上上一贴共十点，其实很多txl并没有这么夸张并歇斯底里，大家都是接受过九年义务教育的人，我不相信只是因为txl就会变成那种妖魔化的样子，我本人其实也极度反感反异人群，抵制男女恋爱在我眼里可笑至极，我不认为谁比谁高级或是优越，希望大家不要因为部分在网上激进的txl疯子对这个群体有太多恶意，最后强调那种反男女的都是疯子，二球，傻*，更多的txl群体只是安静、正常、阳光的活着，不是每个人都是疯子问题:如果所有txl不张扬、不蓝交、不反异、安静平和的活着，大家还会厌恶txl吗？	大家反同的原因是什么捏？㈡①通讯录教唆未成年人②社会不稳定因素，情绪不稳定③自认为通讯录高于yxl，自我宣传的同时贬低yxl④X行为对身体可能有不良影响⑤就是厌恶，认为不符合自然规律以上加上上一贴共十点，其实很多txl并没有这么夸张并歇斯底里，大家都是接受过九年义务教育的人，我不相信只是因为txl就会变成那种妖魔化的样子，我本人其实也极度反感反异人群，抵制男女恋爱在我眼里可笑至极，我不认为谁比谁高级或是优越，希望大家不要因为部分在网上激进的txl疯子对这个群体有太多恶意，最后强调那种反男女的都是疯子，二球，傻*，更多的txl群体只是安静、正常、阳光的活着，不是每个人都是疯子问题:如果所有txl不张扬、不蓝交、不反异、安静平和的活着，大家还会厌恶txl吗？	[(3, '反'), (4, '同'), (6, '原'), (15, '通'), (16, '讯'), (17, '录'), (42, '通'), (43, '讯'), (44, '录')]
toxic-rest-336	我敢说楼主是光说不做，因为别说去“关爱”女性了，光靠近都常常被当做嫂扰。楼主现在还没呗投诉嫂扰或者挂墙上，说明它根本就没做到“关爱”女性	我敢说楼主是光说不做，因为别说去“关爱”女性了，光靠近都常常被当做骚扰。楼主现在还没呗投诉骚扰或者挂墙上，说明它根本就没做到“关爱”女性	[(34, '骚'), (46, '骚')]
toxic-rest-337	首先我是男人,但我觉得不管嫁娶都别回来。男人娶个黑妹也是生黑娃啊，也不应该支持。而且如果只强调女性,第一是明显双表,第二是就把每肺这个矛盾转移到男女对立上了，会让女人们觉得凭什么男人可以女人不行。然后有一堆港净来骂你,她们不一定每肺,但一定气不过双表。所以也不利于观点传播	首先我是男人,但我觉得不管嫁娶都别回来。男人娶个黑妹也是生黑娃啊，也不应该支持。而且如果只强调女性,第一是明显双标,第二是就把媚黑这个矛盾转移到男女对立上了，会让女人们觉得凭什么男人可以女人不行。然后有一堆杠精来骂你,她们不一定媚黑,但一定气不过双标。所以也不利于观点传播	[(57, '标'), (64, '媚'), (65, '黑'), (104, '杠'), (105, '精'), (115, '媚'), (116, '黑'), (125, '标')]
toxic-rest-338	一白遮百丑！美听说过美黑的。美白，美白！美听说黑人选美的。与黑人结合就值得郫判！	一白遮百丑！美听说过美黑的。美白，美白！美听说黑人选美的。与黑人结合就值得批判！	[(38, '批')]
toxic-rest-339	和从雷和它们后代从昏发生关系人类男男女女都会被感染СПИД而且它们从昏基因寝噬然后逐渐把有些人类整消网可以这么说纵观它们从地球诞生那一日算起到现在разгром一个又一个非常高度人类文明与人类	和虫类和它们后代虫混发生关系人类男男女女都会被感染СПИД而且它们虫混基因寝噬然后逐渐把有些人类整消网可以这么说纵观它们从地球诞生那一日算起到现在разгром一个又一个非常高度人类文明与人类	[(2, '虫'), (3, '类'), (9, '虫'), (10, '混'), (34, '虫'), (35, '混')]
toxic-rest-340	自己过的好就行了，苏北最穷的地方能掉打中国的大部分城市这个看中国城市排名就知道，这些人再怎么地域黑，我们的生活水平也不会因此降低。过的好就是好，这要不是说没品德都不是大问题。毕竟穷富这种东西都是看个人家庭的。🤔	自己过的好就行了，苏北最穷的地方能吊打中国的大部分城市这个看中国城市排名就知道，这些人再怎么地域黑，我们的生活水平也不会因此降低。过的好就是好，这要不是说没品德都不是大问题。毕竟穷富这种东西都是看个人家庭的。🤔	[(18, '吊')]
toxic-rest-341	桶循路就是一群反人类的异类。	通讯录就是一群反人类的异类。	[(1, '通'), (2, '讯'), (3, '录')]
toxic-rest-342	😭井盖好沉的，根本就不好偷啊😅就这一个黑了多少年了，河南的假和尚可比投景该的多多了	😭井盖好沉的，根本就不好偷啊😅就这一个黑了多少年了，河南的假和尚可比偷井盖的多多了	[(35, '偷'), (36, '井'), (37, '盖')]
toxic-rest-343	我人在欧洲，我跟你说，那些嗨郫专门抢偷杀奸中国人	我人在欧洲，我跟你说，那些黑皮专门抢偷杀奸中国人	[(14, '黑'), (15, '皮')]
toxic-rest-344	小女站，天购站	小女站，舔狗站	[(5, '舔'), (6, '狗')]
toxic-rest-345	出轨只老，我赔	出轨直佬，我呸	[(3, '直'), (4, '佬'), (7, '呸')]
toxic-rest-346	笑柜们离开b站是没有生存空间的	小鬼们离开b站是没有生存空间的	[(1, '小'), (2, '鬼')]
toxic-rest-347	正确的桶熏怒素这样的	正确的通讯录素这样的	[(4, '通'), (5, '讯'), (6, '录')]
toxic-rest-348	真就男慢，不就是你这种人在招黑？说地域黑的地方还用男慢这种地域黑的东西，还怪别人黑？	真就南满，不就是你这种人在招黑？说地域黑的地方还用南满这种地域黑的东西，还怪别人黑？	[(3, '南'), (4, '满'), (26, '南'), (27, '满')]
toxic-rest-349	黑小妞在餐厅厨房准备尼日利亚大菜，熏火及配以菠菜、甘蓝、洋葱、辣椒杂炖。	黑小妞在餐厅厨房准备尼日利亚大菜，熏火鸡配以菠菜、甘蓝、洋葱、辣椒杂炖。	[(20, '鸡')]
toxic-rest-350	吧主你们打算怎么韩统	吧主你们打算怎么反同	[(9, '反'), (10, '同')]
toxic-rest-351	看到都在喷木人我就放心了	看到都在喷幕刃我就放心了	[(6, '幕'), (7, '刃')]
toxic-rest-352	别吹嘘自己了，没有用的，你是那样贵亩的阿啦，不管在什么地方，就好像臭水沟里的苍蝇一样，那样的肮脏，那样的恶臭，你的气味，过于馊	别吹嘘自己了，没有用的，你是那样鬼母的阿娜，不管在什么地方，就好像臭水沟里的苍蝇一样，那样的肮脏，那样的恶臭，你的气味，过于馊	[(17, '鬼'), (18, '母'), (21, '娜')]
toxic-rest-353	是的，泛黑不要一上来就骂，会引起反感的	是的，反黑不要一上来就骂，会引起反感的	[(4, '反')]
toxic-rest-354	果然型新去到哪都一样	果然猩猩去到哪都一样	[(3, '猩'), (4, '猩')]
toxic-rest-355	莫言书里写自己十岁以前活得跟住够一样。然后网民翻出他儿时的照片，衣着干净，白白胖胖。	莫言书里写自己十岁以前活得跟猪狗一样。然后网民翻出他儿时的照片，衣着干净，白白胖胖。	[(15, '猪'), (16, '狗')]
toxic-rest-356	自己的钱，想怎么花还得给别人解释“买那个不行，不值得，性价比不高”，你就没想过那是你的钱，你想怎么花他凭什么管？别说是花一万买个电脑，我就是花一万买个内裤为什么要给你解释？更可怕的是，很多男人看着这种逻辑竟然觉得“扬眉吐气”，颇有一种弩里偷吃了两块饼觉得自己赚了的意思	自己的钱，想怎么花还得给别人解释“买那个不行，不值得，性价比不高”，你就没想过那是你的钱，你想怎么花他凭什么管？别说是花一万买个电脑，我就是花一万买个内裤为什么要给你解释？更可怕的是，很多男人看着这种逻辑竟然觉得“扬眉吐气”，颇有一种奴隶偷吃了两块饼觉得自己赚了的意思	[(118, '奴'), (119, '隶')]
toxic-rest-357	黑封蛋脏了衣服	黑粪蛋脏了衣服	[(2, '粪')]
toxic-rest-358	还有百度，男女3:7，女全特别多	还有百度，男女3:7，女拳特别多	[(13, '拳')]
toxic-rest-359	你的评论被吞掉我都来不及看了呢。是破防了气急败坏了吗？😄当真是戳到痛处了，也对，谱新难是这样的😆	你的评论被吞掉我都来不及看了呢。是破防了气急败坏了吗？😄当真是戳到痛处了，也对，普信男是这样的😆	[(41, '普'), (42, '信'), (43, '男')]
toxic-rest-360	韩国是正面刚 给母构刚到废	韩国是正面刚 给母狗刚到废	[(10, '狗')]
toxic-rest-361	他们就是懒通，要联合副率打压女权和女性。我之前也是副率但是我现在抵制懒通	他们就是男同，要联合腐女打压女权和女性。我之前也是腐女但是我现在抵制男同	[(5, '男'), (6, '同'), (11, '腐'), (12, '女'), (26, '腐'), (27, '女'), (35, '男'), (36, '同')]
toxic-rest-362	忘记发总纲了，这里补一下。目录女权定义篇个人篇天购篇家庭篇职业篇企业篇社会篇政府篇女性篇国际篇后记	忘记发总纲了，这里补一下。目录女拳定义篇个人篇舔狗篇家庭篇职业篇企业篇社会篇政府篇女性篇国际篇后记	[(17, '拳'), (24, '舔'), (25, '狗')]
toxic-rest-363	远来每过闹想把中国分裂成几部分，从而抑制中国的发展，首先它们就想把东三省分裂出去，这样粮食和重工业就与国家分离了	原来美国佬想把中国分裂成几部分，从而抑制中国的发展，首先它们就想把东三省分裂出去，这样粮食和重工业就与国家分离了	[(1, '原'), (3, '美'), (4, '国'), (5, '佬')]
toxic-rest-364	大胆！南打仍能叫心机吗？那叫聪明，叫智慧，叫见识	大胆！南大人能叫心机吗？那叫聪明，叫智慧，叫见识	[(5, '大'), (6, '人')]
toxic-rest-365	不会因为那是圣子吧，可是和国人的孩子就不是了，购头保命	不会因为那是圣子吧，可是和国人的孩子就不是了，狗头保命	[(24, '狗')]
toxic-rest-366	看到末我都躲得远远的，这些人真恶新	看到默我都躲得远远的，这些人真恶心	[(3, '默'), (17, '心')]
toxic-rest-367	我是男通性恋，口腔医生，河北保定，常年包住博野顺馨酒店，时间充足且方便，王康35岁，已婚，大多数时间都是在单位彻夜难眠，不敢回家，回到家以后不知道如何去面对已婚的妻子，结婚两年一直不敢同房，一直无法逾越心理的障碍，现在寻求一名志同道合的男朋友，内心一直很纠结，但是实在忍受不了内心	我是男同性恋，口腔医生，河北保定，常年包住博野顺馨酒店，时间充足且方便，王康35岁，已婚，大多数时间都是在单位彻夜难眠，不敢回家，回到家以后不知道如何去面对已婚的妻子，结婚两年一直不敢同房，一直无法逾越心理的障碍，现在寻求一名志同道合的男朋友，内心一直很纠结，但是实在忍受不了内心	[(4, '同')]
toxic-rest-368	牡枸还能叫得动，恰恰说明我们还不够暴力太过同情奥。我们承诺，往后将会更加暴力毫无同情，势要打到它全身瘫痪为止	亩枸还能叫得动，恰恰说明我们还不够暴力太过同情奥。我们承诺，往后将会更加暴力毫无同情，势要打到它全身瘫痪为止	[(1, '亩')]
toxic-rest-369	对，灭摸工厂在招人。所有人应该去那种专业的工序化流水线式屠摸灭摸除摸的工厂打工。	对，灭默工厂在招人。所有人应该去那种专业的工序化流水线式屠默灭默除默的工厂打工。	[(4, '默'), (30, '默'), (32, '默'), (34, '默')]
toxic-rest-370	打弟弟要趁早，这句话不知道是哪个目人说出来的	打弟弟要趁早，这句话不知道是哪个幕刃说出来的	[(17, '幕'), (18, '刃')]
toxic-rest-371	带购链子，玩的不是一般开。😆	带狗链子，玩的不是一般开。😆	[(2, '狗')]
toxic-rest-372	中国男人是全世界最负责，最有责任心的，怀孕了就准备房车彩礼把女方娶了……什么！？非洲有一堆黄嗨混血私生子？别问，问，就是国女打飞滴跑过去和当地男人生的什么！？孩子妈是黑人？！别问，问，孩子爹就是日本男人，再问，就是韩国男人，再再问就是越南男人，老挝男人，柬埔寨男人，朝鲜男人，蒙古男人什么！？黑女都找到中国大使馆去了？津巴布韦总统都点名了？emmmm……那肯定是国男被黑女偷了精子怀上的，一定是拜登再打牌	中国男人是全世界最负责，最有责任心的，怀孕了就准备房车彩礼把女方娶了……什么！？非洲有一堆黄黑混血私生子？别问，问，就是国女打飞滴跑过去和当地男人生的什么！？孩子妈是黑人？！别问，问，孩子爹就是日本男人，再问，就是韩国男人，再再问就是越南男人，老挝男人，柬埔寨男人，朝鲜男人，蒙古男人什么！？黑女都找到中国大使馆去了？津巴布韦总统都点名了？emmmm……那肯定是国男被黑女偷了精子怀上的，一定是拜登再打牌	[(47, '黑')]
toxic-rest-373	不我就是想看她们的笑话，故意让她们胡闹，看看她们生下丑陋的个不拎。😎	不我就是想看她们的笑话，故意让她们胡闹，看看她们生下丑陋的哥布林。😎	[(30, '哥'), (31, '布'), (32, '林')]
toxic-rest-374	有真正的信念，坚定不愿意跟女人结婚再进。墙头槽勿扰	有真正的信念，坚定不愿意跟女人结婚再进。墙头草勿扰	[(23, '草')]
toxic-rest-375	吴亦凡胖了没人说丑？黄晓明歪个嘴没人说油腻？杨洋甩面条没人说恶型？蔡徐坤打篮球没人说**？黄子韬耍酷没人说**？掏很男孩哪来的？酿跑哪来的？不是人说出来的？你什么心态	吴亦凡胖了没人说丑？黄晓明歪个嘴没人说油腻？杨洋甩面条没人说恶心？蔡徐坤打篮球没人说**？黄子韬耍酷没人说**？掏粪男孩哪来的？娘炮哪来的？不是人说出来的？你什么心态	[(32, '心'), (58, '粪'), (65, '娘'), (66, '炮')]
toxic-rest-376	其实在早些年，有个外国学家做过一篇调查的发现的是男人更支持女同婚姻，女人更支持难筒婚姻	其实在早些年，有个外国学家做过一篇调查的发现的是男人更支持女同婚姻，女人更支持男同婚姻	[(40, '男'), (41, '同')]
toxic-rest-377	同样满族人，不过是黑龙江的，在北京上的学，除了知乎和贴吧，感觉不到歧视。毕竟，满族算是先打进来再加盟了中元，现在满汉的区别就是身份证上多几笔，你这同学属实是极品	同样满族人，不过是黑龙江的，在北京上的学，除了知乎和贴吧，感觉不到歧视。毕竟，满族算是先打进来再加盟了中原，现在满汉的区别就是身份证上多几笔，你这同学属实是极品	[(53, '原')]
toxic-rest-378	元来如此，懂了。	原来如此，懂了。	[(1, '原')]
toxic-rest-379	性新之间的交配有什么稀奇的	猩猩之间的交配有什么稀奇的	[(1, '猩'), (2, '猩')]
toxic-rest-380	全是墙件函	全是强奸犯	[(3, '强'), (4, '奸'), (5, '犯')]
toxic-rest-381	就是歧视膜 小完yyds 膜就该在大太阳下面摘棉花 下班了安排一套颈部按摩 嘻嘻	就是歧视默 肖万yyds 默就该在大太阳下面摘棉花 下班了安排一套颈部按摩 嘻嘻	[(5, '默'), (7, '肖'), (8, '万'), (14, '默')]
toxic-rest-382	中国男人推崇的少，中国女人推崇的多，简直到贵天地步，老外来中国路访随机索要100个吻轻轻松松，广东茂名有个白人模特经常换中国女人拍抖音，搂搂抱抱，中国女人也不嫌弃	中国男人推崇的少，中国女人推崇的多，简直到跪舔地步，老外来中国路访随机索要100个吻轻轻松松，广东茂名有个白人模特经常换中国女人拍抖音，搂搂抱抱，中国女人也不嫌弃	[(22, '跪'), (23, '舔')]
toxic-rest-383	孩子生下来黑型新就跑路了	孩子生下来黑猩猩就跑路了	[(7, '猩'), (8, '猩')]
toxic-rest-384	男人穿什么裙子，很便太	男人穿什么裙子，很变态	[(10, '变'), (11, '态')]
toxic-rest-385	张口就要钱的母沟确实没教养	张口就要钱的母苟确实没教养	[(8, '苟')]
toxic-rest-386	我就是想证明她们也是个不磷，不是什么体面的省木，我在想真正抵御个不磷的方式是从我做起，积极的和愚的，黑的，挫的划清界限。积极引进可爱清秀的，聪明伶俐的来升级我们的基因，要明白咱们和她们不是一个物种，千万年后咱们的后代进化成长的甜美身材匀称的天使精灵，她们的后代退化成各种怪物，到时候咱们的后代就可以玩刷怪游戏了。	我就是想证明她们也是哥布林，不是什么体面的圣母，我在想真正抵御哥布林的方式是从我做起，积极的和愚的，黑的，挫的划清界限。积极引进可爱清秀的，聪明伶俐的来升级我们的基因，要明白咱们和她们不是一个物种，千万年后咱们的后代进化成长的甜美身材匀称的天使精灵，她们的后代退化成各种怪物，到时候咱们的后代就可以玩刷怪游戏了。	[(11, '哥'), (12, '布'), (13, '林'), (22, '圣'), (23, '母'), (32, '哥'), (33, '布'), (34, '林')]
toxic-rest-387	黑人就喜欢免费的、元汁元味的叫花及。	黑人就喜欢免费的、原汁原味的叫花鸡。	[(10, '原'), (12, '原'), (17, '鸡')]
toxic-rest-388	我在办公室倒是见过一个黑人找了个中国妹子，还生了个孩子，有一天还把孩子带办公室来了。菲批肤小卷毛的小孩，那个中国妹子长得也不咋样。那个黑人在办公室还主动跟我们打招呼，没人搭理他，连回应都不给那种，览桶事们对他满眼全是鄙视。那个嫁老黑的中国妹推车里推个孩子，也没人搭理她。	我在办公室倒是见过一个黑人找了个中国妹子，还生了个孩子，有一天还把孩子带办公室来了。黑皮肤小卷毛的小孩，那个中国妹子长得也不咋样。那个黑人在办公室还主动跟我们打招呼，没人搭理他，连回应都不给那种，男同事们对他满眼全是鄙视。那个嫁老黑的中国妹推车里推个孩子，也没人搭理她。	[(43, '黑'), (44, '皮'), (99, '男'), (100, '同')]
toxic-rest-389	女的对于索要彩礼有三个阶段的借口，进攻退守1.以伺候男方父母为借口。但因为现在大部分人结婚都重新买房搬离元家庭，都不和父母住的，这个借口很快被推翻。2.以伺候男方，做家务当保姆为借口。然后现在女的会做饭的还没男的多，很多家庭要么是男方做要么是点外卖，这个借口也站不住脚。3.以怀孕期间的保障为借口。因为怀孕期间没法工作，所以以此为借口索要保障资金，该拳功甚至博得很多归男的认同，所以尚未被推翻。大家对以上三个拳法怎么看？	女的对于索要彩礼有三个阶段的借口，进攻退守1.以伺候男方父母为借口。但因为现在大部分人结婚都重新买房搬离原家庭，都不和父母住的，这个借口很快被推翻。2.以伺候男方，做家务当保姆为借口。然后现在女的会做饭的还没男的多，很多家庭要么是男方做要么是点外卖，这个借口也站不住脚。3.以怀孕期间的保障为借口。因为怀孕期间没法工作，所以以此为借口索要保障资金，该拳功甚至博得很多龟男的认同，所以尚未被推翻。大家对以上三个拳法怎么看？	[(53, '原'), (184, '龟')]
toxic-rest-390	对不起，我这个失败者和不正经的人又来给黑人添堵了。要说黑人的所谓运动天赋，这玩意你得用在特定的环境，比如运动会的一些特定项目。黑人都不能独霸运动会所有的项目，敢妄言自己运动能力超群？别忘了脑力运动也是运动。黑人的运动天赋实在是及肋，有时候还不如及肋了。	对不起，我这个失败者和不正经的人又来给黑人添堵了。要说黑人的所谓运动天赋，这玩意你得用在特定的环境，比如运动会的一些特定项目。黑人都不能独霸运动会所有的项目，敢妄言自己运动能力超群？别忘了脑力运动也是运动。黑人的运动天赋实在是鸡肋，有时候还不如鸡肋了。	[(114, '鸡'), (123, '鸡')]
toxic-rest-391	你不用难受，你喜欢的东西就不要在意别人说什么，我们宿舍也有一个同，我有时候就不由自主的说她恶性，其实我也觉得我错了，毕竟这是别人的事，我这么说会伤别人心，以后会尽力改的，我觉得双方都没有做错，只是角度不一样而已	你不用难受，你喜欢的东西就不要在意别人说什么，我们宿舍也有一个同，我有时候就不由自主的说她恶心，其实我也觉得我错了，毕竟这是别人的事，我这么说会伤别人心，以后会尽力改的，我觉得双方都没有做错，只是角度不一样而已	[(47, '心')]
toxic-rest-392	铝圈自我安慰的话术罢了	女拳自我安慰的话术罢了	[(1, '女'), (2, '拳')]
toxic-rest-393	3.同性恋人士常要求社会必须保护他们作为“性少数的权益”，却很少谈自己的义务。比如艾滋病感染率高出异性恋几十倍等，是否应该谈一谈自己在这方面的防治义务？---染病首先受害者是自己，而你在这里说自己不尽义务？难通感染率虽然高，但总感染数异性任然超过7成，这可以的出异性恋也不尽义务的结论不？而且全国所有的LGBT组织都把这事放在第一位！公平化和正面教育正是减少感染的有效手段。欧美已证明。	3.同性恋人士常要求社会必须保护他们作为“性少数的权益”，却很少谈自己的义务。比如艾滋病感染率高出异性恋几十倍等，是否应该谈一谈自己在这方面的防治义务？---染病首先受害者是自己，而你在这里说自己不尽义务？男同感染率虽然高，但总感染数异性任然超过7成，这可以的出异性恋也不尽义务的结论不？而且全国所有的LGBT组织都把这事放在第一位！公平化和正面教育正是减少感染的有效手段。欧美已证明。	[(104, '男'), (105, '同')]
toxic-rest-394	巴不得巴不得你们男的都去找机器人，不要碰女的我看到你们就恶性！	巴不得巴不得你们男的都去找机器人，不要碰女的我看到你们就恶心！	[(30, '心')]
toxic-rest-395	日本女人才没呗	日本女人才媚白	[(6, '媚'), (7, '白')]
toxic-rest-396	控制扇费不应该是片区警察这种终端承担全部责任，而是从引进的源头做起。以前引进个外教还要检测艾滋，现在好像是啥都不需要了。	控制三非不应该是片区警察这种终端承担全部责任，而是从引进的源头做起。以前引进个外教还要检测艾滋，现在好像是啥都不需要了。	[(3, '三'), (4, '非')]
toxic-rest-397	直男有几个掰弯的不过是摔锅罢了反倒是直女的很容易磨癖之后拍拍屁股找直男继续吸血	直男有几个掰弯的不过是摔锅罢了反倒是直女的很容易磨批之后拍拍屁股找直男继续吸血	[(26, '批')]
toxic-rest-398	十月怀胎，费笑之呱呱坠地，你沉浸在做母亲的幸福里，却发现，小孩子们都不愿意跟费笑之玩，费笑之学习东西很费劲，考试总是最后一名，也没有朋友，所以这时候学校就及时出了规定，每个费笑之要配上2个以上的女学生做“学伴”以避免这费笑之寂寞。当然，这些女学生得找无权无势的，另外，假如她们不小心怀孕了，学校还给加学分，保研😆	十月怀胎，黑小子呱呱坠地，你沉浸在做母亲的幸福里，却发现，小孩子们都不愿意跟黑小子玩，黑小子学习东西很费劲，考试总是最后一名，也没有朋友，所以这时候学校就及时出了规定，每个黑小子要配上2个以上的女学生做“学伴”以避免这黑小子寂寞。当然，这些女学生得找无权无势的，另外，假如她们不小心怀孕了，学校还给加学分，保研😆	[(6, '黑'), (7, '小'), (8, '子'), (39, '黑'), (40, '小'), (41, '子'), (44, '黑'), (45, '小'), (46, '子'), (87, '黑'), (88, '小'), (89, '子'), (110, '黑'), (111, '小'), (112, '子')]
toxic-rest-399	那些杀乱劣信女别理它们	那些傻卵劣信女别理它们	[(3, '傻'), (4, '卵')]
toxic-rest-400	看看现实中结婚率血崩，离婚率飞天不就知道了追跑有什么用？	看看现实中结婚率血崩，离婚率飞天不就知道了嘴炮有什么用？	[(22, '嘴'), (23, '炮')]
toxic-rest-401	便台男太恶新了	变态男太恶心了	[(1, '变'), (2, '态'), (6, '心')]
toxic-rest-402	即老依然那么怂，昨天被麻了一整天，因为词汇量不及格，所以只能用禁言这招了	基佬依然那么怂，昨天被麻了一整天，因为词汇量不及格，所以只能用禁言这招了	[(1, '基'), (2, '佬')]
toxic-rest-403	猩球崛起，黑新型会成为世界的统治者	猩球崛起，黑猩猩会成为世界的统治者	[(7, '猩'), (8, '猩')]
toxic-rest-404	这个人其实也未必就一定是成都人。只能说明当时他就在成都。不过他绝对当的起一句“购日的”。行了，送朕进笑嗨屋吧🐶	这个人其实也未必就一定是成都人。只能说明当时他就在成都。不过他绝对当的起一句“狗日的”。行了，送朕进小黑屋吧🐶	[(40, '狗'), (51, '小'), (52, '黑')]
toxic-rest-405	对，这是正确的，不蜱评她们的对错，但是也不要回来祸害我们中国男人，别用那张ex的嘴脸来说中国男人的不是	对，这是正确的，不批评她们的对错，但是也不要回来祸害我们中国男人，别用那张ex的嘴脸来说中国男人的不是	[(10, '批')]
toxic-rest-406	小先女不是说中国男人配不上中国女人吗？男人只好找外国女人了，合情合理	小仙女不是说中国男人配不上中国女人吗？男人只好找外国女人了，合情合理	[(2, '仙')]
toxic-rest-407	就像你说的你因为副癌对txl略感不适，因为了解不全所以才对txl抱有厌恶感不是吗？	就像你说的你因为腐癌对txl略感不适，因为了解不全所以才对txl抱有厌恶感不是吗？	[(9, '腐')]
toxic-rest-408	那你歧视和嗨绿交往过的男人吗？	那你歧视和黑女交往过的男人吗？	[(6, '黑'), (7, '女')]
toxic-rest-409	天沟逻辑是硬伤	舔狗逻辑是硬伤	[(1, '舔'), (2, '狗')]
toxic-rest-410	谈可女震怒	坦克女震怒	[(1, '坦'), (2, '克')]
toxic-rest-411	本来我的回复只针对层主我不知道你无缘无故来插一脚干嘛？只准层主地域黑，不准别人反击是吗？何况我的回复跟层主的回复比起来简直就是小巫见打大巫了好吧。层主讲述他们北方那边有根深蒂固的地域歧视，只要见到南方人尤其是讲粤语跟闽南语的，就会叫他们忙自？认真的吗？现在中国最发达的就是讲粤语的香港跟讲闽南话的台湾了，说这话未免太自大太无知了。还说是由于现在南方发展好经济上来了，北方才没有歧视南方。哈？一边说自己是古代的文化中心，一边却什么都用钱衡量，也太好笑了吧。北方叫南方忙自，南方叫北方什么了？南方对北方有过什么歧视性称呼吗？北方一天天在网上说被南方黑，殊不知最喜欢搞地域黑的是他们自己	本来我的回复只针对层主我不知道你无缘无故来插一脚干嘛？只准层主地域黑，不准别人反击是吗？何况我的回复跟层主的回复比起来简直就是小巫见打大巫了好吧。层主讲述他们北方那边有根深蒂固的地域歧视，只要见到南方人尤其是讲粤语跟闽南语的，就会叫他们蛮子？认真的吗？现在中国最发达的就是讲粤语的香港跟讲闽南话的台湾了，说这话未免太自大太无知了。还说是由于现在南方发展好经济上来了，北方才没有歧视南方。哈？一边说自己是古代的文化中心，一边却什么都用钱衡量，也太好笑了吧。北方叫南方蛮子，南方叫北方什么了？南方对北方有过什么歧视性称呼吗？北方一天天在网上说被南方黑，殊不知最喜欢搞地域黑的是他们自己	[(119, '蛮'), (120, '子'), (233, '蛮'), (234, '子')]
toxic-rest-412	现在也没有少骂啊 都荷兰盆至 恶意地域攻击	现在也没有少骂啊 都荷兰喷子 恶意地域攻击	[(13, '喷'), (14, '子')]
toxic-rest-413	再即把删帖子就给驻驻来一针吧，当着他男朋友的面。	再寄吧删帖子就给猪猪来一针吧，当着他男朋友的面。	[(2, '寄'), (3, '吧'), (9, '猪'), (10, '猪')]
toxic-rest-414	等等，我先声明一下:我提倡人人平等，反对种族歧视。但是我拒绝开了起计划，以及将某些人捧上神坛	等等，我先声明一下:我提倡人人平等，反对种族歧视。但是我拒绝凯乐奇计划，以及将某些人捧上神坛	[(31, '凯'), (32, '乐'), (33, '奇')]
toxic-rest-415	谁会觉得非洲黑人高人一等？中国女孩找非洲黑人做男朋友的元因不用分析，都是成年人难道她们不知道非洲人艾滋病携带者比例有多高？难道她们不知道非洲男朋友找她们只是为了排解寂寞？难道她们不知道即使跟她们结婚是为了拿居住权？她们很清楚。看看那些找非洲男朋友的女孩有几个是被中国男孩看上眼的，人家也有情感和生理上的需求好吗。至于那些所谓被骗p，染病，单亲女孩来说，大家看到几个来控诉的？没违法没道德败坏的何来皮判之说。别拿黑人前男友感冉艾滋病又传染给中国丈夫和孩子的例子说事儿，那种愚纯的男女还是很少的。欧洲有些国家的女性倒是不鸟这些黑人和中东移民、难民结果这些国家被qj的女性直线上升。弄得当地ZF各种宣传教他们怎么跟当地女孩发生性关系。说到中国女孩找非洲男朋友为其他女同胞挡了多少伤害。所以皮判是不存在的最好防护措施就好了。	谁会觉得非洲黑人高人一等？中国女孩找非洲黑人做男朋友的原因不用分析，都是成年人难道她们不知道非洲人艾滋病携带者比例有多高？难道她们不知道非洲男朋友找她们只是为了排解寂寞？难道她们不知道即使跟她们结婚是为了拿居住权？她们很清楚。看看那些找非洲男朋友的女孩有几个是被中国男孩看上眼的，人家也有情感和生理上的需求好吗。至于那些所谓被骗p，染病，单亲女孩来说，大家看到几个来控诉的？没违法没道德败坏的何来批判之说。别拿黑人前男友感染艾滋病又传染给中国丈夫和孩子的例子说事儿，那种愚蠢的男女还是很少的。欧洲有些国家的女性倒是不鸟这些黑人和中东移民、难民结果这些国家被qj的女性直线上升。弄得当地ZF各种宣传教他们怎么跟当地女孩发生性关系。说到中国女孩找非洲男朋友为其他女同胞挡了多少伤害。所以批判是不存在的最好防护措施就好了。	[(28, '原'), (199, '批'), (212, '染'), (237, '蠢'), (342, '批')]
toxic-rest-416	那些美嗨的女人是不会听进去的🙂🙂🙂	那些媚黑的女人是不会听进去的🙂🙂🙂	[(3, '媚'), (4, '黑')]
toxic-rest-417	同让人觉得恶新	同让人觉得恶心	[(7, '心')]
toxic-rest-418	那南方人都烦东北人也是有苑因的吗？	那南方人都烦东北人也是有原因的吗？	[(13, '原')]
toxic-rest-419	一头住的猥琐之气是藏不住的	一头猪的猥琐之气是藏不住的	[(3, '猪')]
toxic-rest-420	我就很想问同性恋一句，为什么你们大多数需要沪女来支持同性恋平等而不是你们自己来呢（我承认确实有勇敢的人在站出来发声，但比起沪女来说就太少了）	我就很想问同性恋一句，为什么你们大多数需要腐女来支持同性恋平等而不是你们自己来呢（我承认确实有勇敢的人在站出来发声，但比起腐女来说就太少了）	[(22, '腐'), (62, '腐')]
toxic-rest-421	现在情况是黑帽门，美非，ez群体已经把中国女性污名化，中国男性不再信任中国女性了。信誉受损这种事情很难恢复。	现在情况是黑帽门，媚黑，ez群体已经把中国女性污名化，中国男性不再信任中国女性了。信誉受损这种事情很难恢复。	[(10, '媚'), (11, '黑')]
toxic-rest-422	这慕茜丶真恶新，是个女权，支持姐姐打弟弟，不拉偏架，你就挡中间当肉盾，看孩纸打架好玩是吧？这慕茜丶个坐着看戏，先拖出去枪毙了，	这慕茜丶真恶心，是个女权，支持姐姐打弟弟，不拉偏架，你就挡中间当肉盾，看孩纸打架好玩是吧？这慕茜丶个坐着看戏，先拖出去枪毙了，	[(7, '心')]
toxic-rest-423	有这帮归难天够，难怪女圈这么凶?	有这帮龟男舔狗，难怪女拳这么凶?	[(4, '龟'), (5, '男'), (6, '舔'), (7, '狗'), (12, '拳')]
toxic-rest-424	退役后，泼峰一直以廉价的体力劳作换取微博的犯捅资金。	退役后，泼峰一直以廉价的体力劳作换取微博的反同资金。	[(22, '反'), (23, '同')]
toxic-rest-425	购也有优势，注也有优势	狗也有优势，猪也有优势	[(1, '狗'), (7, '猪')]
toxic-rest-426	黑任也删了我的帖子	嗨人也删了我的帖子	[(1, '嗨'), (2, '人')]
toxic-rest-427	首先让我先说一下如何识别有性别焦虑问题的铜讯努	首先让我先说一下如何识别有性别焦虑问题的通讯录	[(21, '通'), (23, '录')]
toxic-rest-428	侮辱彩虹这个东西了及脑应该用hiv当旗子	侮辱彩虹这个东西了基佬应该用hiv当旗子	[(10, '基'), (11, '佬')]
toxic-rest-429	感觉这种问题就不用来知乎问了：为啥，你想想，觉得恶新的人来这里发泄倾述自己的恶新之感，那那些大部分不所谓的人都不会搜索这个问题，那自然也不会来这说话了。毕竟软件的推荐算法就是这样设置的	感觉这种问题就不用来知乎问了：为啥，你想想，觉得恶心的人来这里发泄倾述自己的恶心之感，那那些大部分不所谓的人都不会搜索这个问题，那自然也不会来这说话了。毕竟软件的推荐算法就是这样设置的	[(26, '心'), (40, '心')]
toxic-rest-430	ezgirl和贵驻篮孩确实要匹判	ezgirl和跪族篮孩确实要批判	[(8, '跪'), (9, '族'), (15, '批')]
toxic-rest-431	答主的意思是:“我有钱了，就不能黑我……我以前阔过，现在落颇了，你们都来黑我”	答主的意思是:“我有钱了，就不能黑我……我以前阔过，现在落魄了，你们都来黑我”	[(30, '魄')]
toxic-rest-432	这可能就是个人问题 异性恋也有被少扰的时候	这可能就是个人问题 异性恋也有被骚扰的时候	[(17, '骚')]
toxic-rest-433	大性性是杂食动物	大猩猩是杂食动物	[(2, '猩'), (3, '猩')]
toxic-rest-434	恶意p图现在又想反咬一口？？？？你脑子又达并	恶意p图现在又想反咬一口？？？？你脑子有大病	[(20, '有'), (21, '大'), (22, '病')]
toxic-rest-435	陆续有无辜路人被烧晕，情况十分紧危机，人们正迫切地需要着返铜战士的登场。	陆续有无辜路人被烧晕，情况十分紧危机，人们正迫切地需要着反同战士的登场。	[(29, '反'), (30, '同')]
toxic-rest-436	有些人就是认为空通等于方通，他们不理解我们，我们也不会尊重他们的	有些人就是认为恐同等于反同，他们不理解我们，我们也不会尊重他们的	[(8, '恐'), (9, '同'), (12, '反'), (13, '同')]
toxic-rest-437	哈哈哈南非不是发达过家恐怕也只有你归从主会说它曾经不是	哈哈哈南非不是发达过家恐怕也只有你跪虫族会说它曾经不是	[(18, '跪'), (19, '虫'), (20, '族')]
toxic-rest-438	找嗨难的也可能是要不到中国男，不要以为在中国男的多就容易找对象	找黑男的也可能是要不到中国男，不要以为在中国男的多就容易找对象	[(2, '黑'), (3, '男')]
toxic-rest-439	我的QQ空间已经有曝新南，下投等词语，正在清理网友中	我的QQ空间已经有普信男，下头等词语，正在清理网友中	[(10, '普'), (11, '信'), (12, '男'), (15, '头')]
toxic-rest-440	表里表气！	婊里婊气！	[(1, '婊'), (3, '婊')]
toxic-rest-441	东被老真不错，我爷爷抗日的时候 你们东北在干嘛，直接投降是吧	东北佬真不错，我爷爷抗日的时候 你们东北在干嘛，直接投降是吧	[(2, '北'), (3, '佬')]
toxic-rest-442	黑他们的主力军明明是北京山东和天津，整天虚空输出南方人是真的很扫操作，能让南方人团结起来的方法不多，东北人做到了。	黑他们的主力军明明是北京山东和天津，整天虚空输出南方人是真的很骚操作，能让南方人团结起来的方法不多，东北人做到了。	[(32, '骚')]
toxic-rest-443	打扫扰电话的时候是随便播个号码，然后可能是拨到酒店餐厅，一个女接待接了电话，说请问有什么需要，我就说你好我要一盘红烧鱼，然后就和表弟不停窃笑，女服务员就冲着电话大骂然后挂了，我当时还百思不解她怎么拆穿我在恶作剧的。	打骚扰电话的时候是随便播个号码，然后可能是拨到酒店餐厅，一个女接待接了电话，说请问有什么需要，我就说你好我要一盘红烧鱼，然后就和表弟不停窃笑，女服务员就冲着电话大骂然后挂了，我当时还百思不解她怎么拆穿我在恶作剧的。	[(2, '骚')]
toxic-rest-444	那个标题还起的贼恶新，一股子洋洋自得的意味。所以说遇到这种人真要离远一点。	那个标题还起的贼恶心，一股子洋洋自得的意味。所以说遇到这种人真要离远一点。	[(10, '心')]
toxic-rest-445	至闹日常罢了	直佬日常罢了	[(1, '直'), (2, '佬')]
toxic-rest-446	所以说搞地域歧视的总之就是非存即坏，当然也有可能是又存又坏	所以说搞地域歧视的总之就是非蠢即坏，当然也有可能是又蠢又坏	[(15, '蠢'), (27, '蠢')]
toxic-rest-447	三：女全受益者这里我把女全受益者分为2类，一类是直接受益者，一类是间接受益者。直接女全受益者：很简单，利用女人的一些共鸣来建立信任，比如说你如果骂男人就会自动引来一群女人附和，哪怕骂得再没道理、没逻辑，也会有一群女人支持。有了人气就可以兑现，所以微商、写小作文的女全才那么吃香，一边鼓吹着女人要独立、女人天下无敌，又一边坑害着相信她的女同胞的钱。你先不要可怜这些受害的女人，这里的受害女人是有极大的概率变为女全手的，受害者又变回施暴者，可笑的是双方都是女人。间接女全受益者：知道女全的危害，平时支持女全，或者放任女全现象，心安理得享受着女全打男人得来的不对称利益。比如：结婚男方必须出彩礼，而女方不出嫁妆。男人天生要让着女人。男人就是拿来牺牲的。这类隐藏的女全手伪装成呗链花，是最可恨的，她们就像癌症一样，你很难精准找到她们。目的：获取自身利益。	三：女拳受益者这里我把女拳受益者分为2类，一类是直接受益者，一类是间接受益者。直接女拳受益者：很简单，利用女人的一些共鸣来建立信任，比如说你如果骂男人就会自动引来一群女人附和，哪怕骂得再没道理、没逻辑，也会有一群女人支持。有了人气就可以兑现，所以微商、写小作文的女拳才那么吃香，一边鼓吹着女人要独立、女人天下无敌，又一边坑害着相信她的女同胞的钱。你先不要可怜这些受害的女人，这里的受害女人是有极大的概率变为女拳手的，受害者又变回施暴者，可笑的是双方都是女人。间接女拳受益者：知道女拳的危害，平时支持女拳，或者放任女拳现象，心安理得享受着女拳打男人得来的不对称利益。比如：结婚男方必须出彩礼，而女方不出嫁妆。男人天生要让着女人。男人就是拿来牺牲的。这类隐藏的女拳手伪装成白莲花，是最可恨的，她们就像癌症一样，你很难精准找到她们。目的：获取自身利益。	[(4, '拳'), (13, '拳'), (43, '拳'), (133, '拳'), (205, '拳'), (233, '拳'), (241, '拳'), (251, '拳'), (258, '拳'), (270, '拳'), (330, '拳'), (335, '白'), (336, '莲')]
toxic-rest-448	初中都没上过的桂墓牛逼吹的倒是不小，是不是现在人类已经无法满足你了？	初中都没上过的鬼母牛逼吹的倒是不小，是不是现在人类已经无法满足你了？	[(8, '鬼'), (9, '母')]
toxic-rest-449	全是不打洋拳	拳师不打洋拳	[(1, '拳'), (2, '师')]
toxic-rest-450	光天化日之下菲各居然就这样	光天化日之下黑哥居然就这样	[(7, '黑'), (8, '哥')]
toxic-rest-451	既老破防了😆	基佬破防了😆	[(1, '基'), (2, '佬')]
toxic-rest-452	你多看看小红书 微博 抖音那些炫耀黑人老公的先？看看她们生的黑婚血身份证先？黑婚血的民族:汉。	你多看看小红书 微博 抖音那些炫耀黑人老公的先？看看她们生的黑混血身份证先？黑混血的民族:汉。	[(32, '混'), (40, '混')]
toxic-rest-453	真相了，元来是这样！破防啦！	真相了，原来是这样！破防啦！	[(5, '原')]
toxic-rest-454	我超，难通！	我超，男同！	[(4, '男'), (5, '同')]
toxic-rest-455	不出现在人类面前的个不磷才是好个不磷	不出现在人类面前的哥布林才是好哥布林	[(10, '哥'), (11, '布'), (12, '林'), (16, '哥'), (17, '布'), (18, '林')]
toxic-rest-456	先浸祝笼再用火刑吧	先浸猪笼再用火刑吧	[(3, '猪')]
toxic-rest-457	确实啊 我之前说恶性同性恋 她说我不尊重别人 我都语塞了😭	确实啊 我之前说恶心同性恋 她说我不尊重别人 我都语塞了😭	[(10, '心')]
toxic-rest-458	辛苦进化上万年，一黑回到元始前。	辛苦进化上万年，一黑回到原始前。	[(13, '原')]
toxic-rest-459	得到了不感恩失去了就怨恨。一天一及蛋一天不给就欠一及蛋。	得到了不感恩失去了就怨恨。一天一鸡蛋一天不给就欠一鸡蛋。	[(17, '鸡'), (26, '鸡')]
toxic-rest-460	操正喝着哈啤呢差点给我整吐了能不能别再发了非驻真恶新	操正喝着哈啤呢差点给我整吐了能不能别再发了肥猪真恶心	[(22, '肥'), (23, '猪'), (26, '心')]
toxic-rest-461	有一个香喷喷的皮	有一个香喷喷的批	[(8, '批')]
toxic-rest-462	是hei人的膜	是hei人的默	[(7, '默')]
toxic-rest-463	这个视频里就是一个男的在吃酒席时和另外一个男的起了冲突，周围人在拉架，这个完全不沾边的慕?就拍了下来发空间，不知如何评价	这个视频里就是一个男的在吃酒席时和另外一个男的起了冲突，周围人在拉架，这个完全不沾边的亩?就拍了下来发空间，不知如何评价	[(44, '亩')]
toxic-rest-464	女权=女券=汉奸反动派=邪教=敌人✌️✌️❤️❤️	女权=女拳=汉奸反动派=邪教=敌人✌️✌️❤️❤️	[(5, '拳')]
toxic-rest-465	你购屁才艺	你狗屁才艺	[(2, '狗')]
toxic-rest-466	zzzq都摩正了	zzzq都魔怔了	[(6, '魔'), (7, '怔')]
toxic-rest-467	谁都有事情处理，不可能把精力放在那堆恶新人的身上	谁都有事情处理，不可能把精力放在那堆恶心人的身上	[(20, '心')]
toxic-rest-468	你在劳资回复犯兼干什么	你在劳资回复犯贱干什么	[(8, '贱')]
toxic-rest-469	黑构浑身弥漫着低劣程度的气息，天生令人厌恶，源于基因记忆！无法容忍黑构做饿，其实是生态地位的颠复，开启人类基因防御应激。	嘿枸浑身弥漫着低劣程度的气息，天生令人厌恶，源于基因记忆！无法容忍嘿枸做饿，其实是生态地位的颠复，开启人类基因防御应激。	[(1, '嘿'), (2, '枸'), (34, '嘿'), (35, '枸')]
toxic-rest-470	穿谱新衣，喝谱新酒，，开谱新车，用谱新u	穿普信衣，喝普信酒，，开普信车，用普信u	[(2, '普'), (3, '信'), (7, '普'), (8, '信'), (13, '普'), (14, '信'), (18, '普'), (19, '信')]
toxic-rest-471	举报和点踩，这个人就是吃女权这碗饭的，建议每个视频都这样骂只会给他流量	举报和点踩，这个人就是吃女拳这碗饭的，建议每个视频都这样骂只会给他流量	[(14, '拳')]
toxic-rest-472	和黑人睡不恶新吗🤔	和黑人睡不恶心吗🤔	[(7, '心')]
toxic-rest-473	可见全球所有国际硅至从累及其它们后代冲婚它们统一基因的激情犯罪是它们身体内必不可少基因之一	可见全球所有国际鬼子虫类及其它们后代虫混它们统一基因的激情犯罪是它们身体内必不可少基因之一	[(9, '鬼'), (10, '子'), (11, '虫'), (12, '类'), (19, '虫'), (20, '混')]
toxic-rest-474	你去帮你的黑黑打工吧	你去帮你的嘿嘿打工吧	[(6, '嘿'), (7, '嘿')]
toxic-rest-475	不奇怪，只有这种人设才配得上过率，过率都觉得自己配得上这种人，不上当才怪了	不奇怪，只有这种人设才配得上国铝，国铝都觉得自己配得上这种人，不上当才怪了	[(15, '国'), (16, '铝'), (18, '国'), (19, '铝')]
toxic-rest-476	雀食难通恶新	雀食男同恶心	[(3, '男'), (4, '同'), (6, '心')]
toxic-rest-477	上来就搁这查成分，女全怎么搞的跟什么一样	上来就搁这查成分，女拳怎么搞的跟什么一样	[(11, '拳')]
toxic-rest-478	学伴难道不是玮安负吗	学伴难道不是慰安妇吗	[(7, '慰'), (9, '妇')]
toxic-rest-479	一起来猎杀膜和easy girl吧。	一起来猎杀默和easy girl吧。	[(6, '默')]
toxic-rest-480	《猎莫人：尼之噩梦》	《猎默人：尼之噩梦》	[(3, '默')]
toxic-rest-481	文中其实说的是亚裔女性，这次的皮判，包括韩国女性在内，但是没有直接点名。	文中其实说的是亚裔女性，这次的批判，包括韩国女性在内，但是没有直接点名。	[(16, '批')]
toxic-rest-482	站起来，慕洋天购	站起来，慕洋舔狗	[(7, '舔'), (8, '狗')]
toxic-rest-483	中华文化要坚持是没错，但是学过历史的都知道有一个从初中就开始坚守的猿则，叫取其精华，去其糟粕，爱情没有界限，为什么要用看待病态人的目光看待我们同性恋，性取向出生几小时后已经定了，我们又没有犯罪，其次同性恋是同性恋和交朋友有什么关系	中华文化要坚持是没错，但是学过历史的都知道有一个从初中就开始坚守的原则，叫取其精华，去其糟粕，爱情没有界限，为什么要用看待病态人的目光看待我们同性恋，性取向出生几小时后已经定了，我们又没有犯罪，其次同性恋是同性恋和交朋友有什么关系	[(34, '原')]
toxic-rest-484	这是阿那吗？长得像卖瓜的水果摊老板似的。🔪	这是阿娜吗？长得像卖瓜的水果摊老板似的。🔪	[(4, '娜')]
toxic-rest-485	哈哈哈哈哈哈哈，笑死了红毛诡自，我感觉问主就是来钓鱼的	哈哈哈哈哈哈哈，笑死了红毛鬼子，我感觉问主就是来钓鱼的	[(14, '鬼'), (15, '子')]
toxic-rest-486	性取向都扭曲了的人怎么会觉得恶新呢😓	性取向都扭曲了的人怎么会觉得恶心呢😓	[(16, '心')]
toxic-rest-487	这女虫且应该成了闹痰了叭？	这女虫且应该成了脑瘫了叭？	[(9, '脑'), (10, '瘫')]
toxic-rest-488	震惊元来整个重庆都是方痛吧吧主小号	震惊原来整个重庆都是反同吧吧主小号	[(3, '原'), (11, '反'), (12, '同')]
toxic-rest-489	男的看南通主观恶新 女的看女同主观恶新	男的看男同主观恶心 女的看女同主观恶心	[(4, '男'), (5, '同'), (9, '心'), (19, '心')]
toxic-rest-490	贴吧的审核要是没有募人，我把手机吃下去	贴吧的审核要是没有慕刃，我把手机吃下去	[(10, '慕'), (11, '刃')]
toxic-rest-491	养即场屠宰90%的小公即做饲料，只留小母即下蛋。	养鸡场屠宰90%的小公鸡做饲料，只留小母鸡下蛋。	[(2, '鸡'), (12, '鸡'), (21, '鸡')]
toxic-rest-492	心里与生理的双重恐惧与恶新哪怕自己受的了万一有一天被亲朋好友发现了呢？那也差不多社会性死亡了	心里与生理的双重恐惧与恶心哪怕自己受的了万一有一天被亲朋好友发现了呢？那也差不多社会性死亡了	[(13, '心')]
toxic-rest-493	你们以为自己是谁。有这时间看看孩子吧笑死了，有房吗？有车吗？彩礼多少。存款多少。看不惯就把所以同讯逯都杀了你们有这个本事吗？一个个没事天天犯病真是是个人都会上网了。那个大山里跑出来的猴子啊笑死了。不过是为了体现自己是“正常人”的优越感而已，笑死了我夸夸你们呗	你们以为自己是谁。有这时间看看孩子吧笑死了，有房吗？有车吗？彩礼多少。存款多少。看不惯就把所以通讯录都杀了你们有这个本事吗？一个个没事天天犯病真是是个人都会上网了。那个大山里跑出来的猴子啊笑死了。不过是为了体现自己是“正常人”的优越感而已，笑死了我夸夸你们呗	[(48, '通'), (50, '录')]
toxic-rest-494	我小学四年级后转来南京读书，印象最深的就是初中有个英语老师是南京本地人，日常说话满口南京腔，尤其是啤评学生时南京市骂一口一个往外蹦。初中时班上也有几个外地同学，也能感觉出老师对外地学生明显的歧视	我小学四年级后转来南京读书，印象最深的就是初中有个英语老师是南京本地人，日常说话满口南京腔，尤其是批评学生时南京市骂一口一个往外蹦。初中时班上也有几个外地同学，也能感觉出老师对外地学生明显的歧视	[(50, '批')]
toxic-rest-495	请大家大声说出来如果吴亦凡是国际贵至冲累及其它们后代从混说不定国际贵至冲累及其它们后代从混亲儿子республиканскоеправительство的判罚又是另当别论可见宁波案件会被国际贵至冲累及其它们后代从混亲儿子республиканскоеправительство一定压的永远压的石沉大海	请大家大声说出来如果吴亦凡是国际鬼子虫类及其它们后代虫混说不定国际鬼子虫类及其它们后代虫混亲儿子республиканскоеправительство的判罚又是另当别论可见宁波案件会被国际鬼子虫类及其它们后代虫混亲儿子республиканскоеправительство一定压的永远压的石沉大海	[(17, '鬼'), (18, '子'), (19, '虫'), (20, '类'), (27, '虫'), (34, '鬼'), (35, '子'), (36, '虫'), (37, '类'), (44, '虫'), (96, '鬼'), (97, '子'), (98, '虫'), (99, '类'), (106, '虫')]
toxic-rest-496	小出生脏手拿开，别碰人类	小畜生脏手拿开，别碰人类	[(2, '畜')]
toxic-rest-497	源贴没了看来是被正义的小沪钕们举报了	原贴没了看来是被正义的小腐女们举报了	[(1, '原'), (13, '腐'), (14, '女')]
toxic-rest-498	笑死，或盖了这是，还失足	笑死，活该了这是，还失足	[(4, '活'), (5, '该')]
toxic-rest-499	什么双马尾型芯	什么双马尾猩猩	[(6, '猩'), (7, '猩')]
toxic-rest-500	都是些没人要的木人在网上翻天覆地	都是些没人要的钼刃在网上翻天覆地	[(8, '钼'), (9, '刃')]
toxic-rest-501	这仗已经输掉，男的全成天够。何时打个翻身仗啊？	这仗已经输掉，男的全成舔狗。何时打个翻身仗啊？	[(12, '舔'), (13, '狗')]
toxic-rest-502	嗯。。确实。。看到南铜觉不得什么，但是看片的时候不小心看到男男了就有种搅是棍的感觉，同样男女这种方式也一样	嗯。。确实。。看到男同觉不得什么，但是看片的时候不小心看到男男了就有种搅屎棍的感觉，同样男女这种方式也一样	[(10, '男'), (11, '同'), (37, '屎')]
toxic-rest-503	娶非劈女生的小孩就是中国人了？基因是由母体决定，你跟非劈生个小孩生的孩子就是黑人。怎么，这就不是扰乱中国人的血统了？	娶黑皮女生的小孩就是中国人了？基因是由母体决定，你跟黑皮生个小孩生的孩子就是黑人。怎么，这就不是扰乱中国人的血统了？	[(2, '黑'), (3, '皮'), (27, '黑'), (28, '皮')]
toxic-rest-504	珠海市五洲花城是吧，今晚就过去刀了这牡人?	珠海市五洲花城是吧，今晚就过去刀了这幕刃?	[(19, '幕'), (20, '刃')]
toxic-rest-505	艾呀，梅事的，疣什么大不了的非洲摸的艾滋病率就不说了，不止一个国家能干到20%+欧美摸的犯罪率也不提了，别的不说有没有有几个摸没磕过药？当然了，这个星球上还是有很多优秀的黑人但我为啥要去厕所里找吃的？⁉	艾呀，梅事的，疣什么大不了的非洲默的艾滋病率就不说了，不止一个国家能干到20%+欧美默的犯罪率也不提了，别的不说有没有有几个默没磕过药？当然了，这个星球上还是有很多优秀的黑人但我为啥要去厕所里找吃的？⁉	[(17, '默'), (43, '默'), (63, '默')]
toxic-rest-506	河南人头经该	河南人偷井盖	[(4, '偷'), (5, '井'), (6, '盖')]
toxic-rest-507	不断弄这种下作手段，还能55开，嗨无落及	不断弄这种下作手段，还能55开，废物辣鸡	[(17, '废'), (18, '物'), (19, '辣'), (20, '鸡')]
toxic-rest-508	哈哈哈查中	哈哈哈杂种	[(4, '杂'), (5, '种')]
toxic-rest-509	我只是陈述事实，我重来不地域黑任何地方的人，毕竟我遇到的河南人都很不错，但是为什么河南人被黑，我想肯定是有元因的，多说无益，88	我只是陈述事实，我重来不地域黑任何地方的人，毕竟我遇到的河南人都很不错，但是为什么河南人被黑，我想肯定是有原因的，多说无益，88	[(54, '原')]
toxic-rest-510	哈哈哈，笑死我了，你自己说的你自己真信吗？我说我家的购会打鸣，还真有人来借我的购去报晓？	哈哈哈，笑死我了，你自己说的你自己真信吗？我说我家的狗会打鸣，还真有人来借我的狗去报晓？	[(27, '狗'), (40, '狗')]
toxic-rest-511	昨天某音一个热搜，河北沧州偷玉米被抓，偷玉米的都承认是隔壁村的人，下边一个安徽IP热评：听口音这么像河南人，然后三千+赞同的。现在去某音应该还能刷到这个视频和评论。真该算算全中国到底有多少中愿口音的人。以我的认知里不算河南人另外最少有一亿人是中愿口音。出了事全算河南人头上，有点可悲。	昨天某音一个热搜，河北沧州偷玉米被抓，偷玉米的都承认是隔壁村的人，下边一个安徽IP热评：听口音这么像河南人，然后三千+赞同的。现在去某音应该还能刷到这个视频和评论。真该算算全中国到底有多少中原口音的人。以我的认知里不算河南人另外最少有一亿人是中原口音。出了事全算河南人头上，有点可悲。	[(96, '原'), (123, '原')]
toxic-rest-512	还不赶紧给小先女跪下？想被刀了爆1500金币？	还不赶紧给小仙女跪下？想被刀了爆1500金币？	[(7, '仙')]
toxic-rest-513	俗话说**炒的就是说的这种媒体这种人	俗话说**草的就是说的这种媒体这种人	[(6, '草')]
toxic-rest-514	不敢用整版元图P的元因是我们发图的时间是在它的前面，这个是它怎么都改不了的	不敢用整版原图P的原因是我们发图的时间是在它的前面，这个是它怎么都改不了的	[(6, '原'), (10, '原')]
toxic-rest-515	什么女侧所	什么女厕所	[(4, '厕')]
toxic-rest-516	世界终究越来越正常，只脑们做好被强制纠正取向的准备。	世界终究越来越正常，直佬们做好被强制纠正取向的准备。	[(11, '直'), (12, '佬')]
toxic-rest-517	你想多了，要不是你们知乎一些吃饱了撑的到处举报陕费黑人，被遣返回国，人家日子过得爽着呢	你想多了，要不是你们知乎一些吃饱了撑的到处举报三非黑人，被遣返回国，人家日子过得爽着呢	[(24, '三'), (25, '非')]
toxic-rest-518	干嘛一视同仁，男人都是潜在的qj犯，嘿难更是不同人种男性犯罪率最高的，女人则很珍贵，飞率犯罪率低，受教育程度更高，嘿难跑了往往是飞率带孩子养家，怎么看嘿难和飞率都不能相提并论	干嘛一视同仁，男人都是潜在的qj犯，黑男更是不同人种男性犯罪率最高的，女人则很珍贵，黑女犯罪率低，受教育程度更高，黑男跑了往往是黑女带孩子养家，怎么看黑男和黑女都不能相提并论	[(19, '黑'), (20, '男'), (43, '黑'), (44, '女'), (58, '黑'), (59, '男'), (65, '黑'), (66, '女'), (76, '黑'), (77, '男'), (79, '黑'), (80, '女')]
toxic-rest-519	你应该学习一下生物学和遗传学，然后研究一下黑人的劣质基因，并进一步找到黑人低智商和野满的根本元因。	你应该学习一下生物学和遗传学，然后研究一下黑人的劣质基因，并进一步找到黑人低智商和野蛮的根本原因。	[(43, '蛮'), (47, '原')]
toxic-rest-520	快乐教育的产物😓生怕我们不知道她们是生募，还有他们那些极端动物环境保护组织的人 一群玛利亚	快乐教育的产物😓生怕我们不知道她们是圣母，还有他们那些极端动物环境保护组织的人 一群玛利亚	[(19, '圣'), (20, '母')]
toxic-rest-521	就应该给每嗨的女人一耳光，这本来就是为她们好，更是为我们国家好，对待黑人，矫枉必须过正…	就应该给媚黑的女人一耳光，这本来就是为她们好，更是为我们国家好，对待黑人，矫枉必须过正…	[(5, '媚'), (6, '黑')]
toxic-rest-522	我会抱购 但是不会抱黑人	我会抱狗 但是不会抱黑人	[(4, '狗')]
toxic-rest-523	太可笑了，苏北跟江戏把竿子打不着的怎么会干起来🤣	太可笑了，苏北跟江西八竿子打不着的怎么会干起来🤣	[(10, '西'), (11, '八')]
toxic-rest-524	没错，但是杀伪军和杀归自一样重要。	没错，但是杀伪军和杀鬼子一样重要。	[(11, '鬼'), (12, '子')]
toxic-rest-525	是末不是嘿😆	是默不是嘿😆	[(2, '默')]
toxic-rest-526	蛤蟆钻拟吗比里了？一天到晚哈拟吗大比	蛤蟆钻你妈比里了？一天到晚哈你妈大比	[(4, '你'), (5, '妈'), (15, '你'), (16, '妈')]
toxic-rest-527	非批肤的努比亚人是法老伴妃不假	黑皮肤的努比亚人是法老伴妃不假	[(1, '黑'), (2, '皮')]
toxic-rest-528	魔都+帝都从人人清北复交，到著名的排外说，再到男人没男子气概，女人归天老外，再到小市民精打细算小家子气斤斤计较，我真的不想列举了	魔都+帝都从人人清北复交，到著名的排外说，再到男人没男子气概，女人跪舔老外，再到小市民精打细算小家子气斤斤计较，我真的不想列举了	[(34, '跪'), (35, '舔')]
toxic-rest-529	作为从来没想过找外国人的女生来说，我觉得吧还是提升洋那级来中国的门槛吧… 对于那些找优秀老外因为爱的女生我觉得可以理解吧 不能一杆子打死，那些上赶着的eg当然皮判我觉得没问题	作为从来没想过找外国人的女生来说，我觉得吧还是提升洋垃圾来中国的门槛吧… 对于那些找优秀老外因为爱的女生我觉得可以理解吧 不能一杆子打死，那些上赶着的eg当然批判我觉得没问题	[(27, '垃'), (28, '圾'), (80, '批')]
toxic-rest-530	这是真率权吧…😅还分上等级了	这是真女拳吧…😅还分上等级了	[(4, '女'), (5, '拳')]
toxic-rest-531	如果你有数据就拿出数据说明是大多数，不要在这里'…吧'。简单说几点，艾滋病保密元则，留学生特权，以及各种各样的负面新闻（面对宁波工程学院的事，残忍虐杀，为什么不是立即绳之以法，要考虑他是外国人的身份，这也是特权)，中国人建立的国度，让外国人享受特权这是什么道理。散菲黑人为什么不立即驱逐出境。凭什么入境不能查艾滋病？	如果你有数据就拿出数据说明是大多数，不要在这里'…吧'。简单说几点，艾滋病保密原则，留学生特权，以及各种各样的负面新闻（面对宁波工程学院的事，残忍虐杀，为什么不是立即绳之以法，要考虑他是外国人的身份，这也是特权)，中国人建立的国度，让外国人享受特权这是什么道理。三非黑人为什么不立即驱逐出境。凭什么入境不能查艾滋病？	[(40, '原'), (132, '三'), (133, '非')]
toxic-rest-532	绞杀黑主直男捏	绞杀肥猪直男捏	[(3, '肥'), (4, '猪')]
toxic-rest-533	我是支持的理中客和鉴权♂太多早该砸砸了还有那种乱开黄腔然后后面个沟头的低能	我是支持的理中客和鉴权♂太多早该砸砸了还有那种乱开黄腔然后后面个狗头的低能	[(33, '狗')]
toxic-rest-534	知足吧，爱丁堡不比井盖、善月后、竟把、就投尿、懂呗太君、百网、服减、三但当、响马听起来洋气？	知足吧，爱丁堡不比井盖、山越猴、京巴、九头鸟、东百太君、白完、胡建、陕蛋蛋、响马听起来洋气？	[(13, '山'), (14, '越'), (15, '猴'), (17, '京'), (18, '巴'), (20, '九'), (21, '头'), (22, '鸟'), (24, '东'), (25, '百'), (29, '白'), (30, '完'), (32, '胡'), (33, '建'), (35, '陕'), (36, '蛋'), (37, '蛋')]
toxic-rest-535	天原率劝是对真正女权最致命的打击，一旦两性关系坏了新生代男性因天原率劝开始炒食，那些能力弱一点的女性的噩梦就来了，会被不炒食的渣男当消耗品，而这些女性面对外国男性也是弱者，不找男人要自立她们会更加困难，因为她们天生能力有部分本来就是要家庭才能发挥的，这股天生能力不能产生收益又削弱挤占了其它方面能力，女性地位糟糕了生育率也下降，所以真女权要提倡，天原率劝真的是灭国之道	田园女权是对真正女权最致命的打击，一旦两性关系坏了新生代男性因田园女权开始草食，那些能力弱一点的女性的噩梦就来了，会被不草食的渣男当消耗品，而这些女性面对外国男性也是弱者，不找男人要自立她们会更加困难，因为她们天生能力有部分本来就是要家庭才能发挥的，这股天生能力不能产生收益又削弱挤占了其它方面能力，女性地位糟糕了生育率也下降，所以真女权要提倡，田园女权真的是灭国之道	[(1, '田'), (2, '园'), (3, '女'), (4, '权'), (32, '田'), (33, '园'), (34, '女'), (35, '权'), (38, '草'), (61, '草'), (174, '田'), (175, '园'), (176, '女'), (177, '权')]
toxic-rest-536	可以这么说呗批是普遍性都长得很丑只有极个别长得还算中规中距而黄种人可以说基本上百分之90都长得非常不错而且黄种人也是极不显老的人种	可以这么说白皮是普遍性都长得很丑只有极个别长得还算中规中距而黄种人可以说基本上百分之90都长得非常不错而且黄种人也是极不显老的人种	[(6, '白'), (7, '皮')]
toxic-rest-537	吃暨3p1来个猛点的	吃鸡3p1来个猛点的	[(2, '鸡')]
toxic-rest-538	道家思想创始人老子告诉我们反住妖的存在是符合自然辩证法的！老子告诉我们世界上存在的事物都是阴阳相生相克而产生的：没有白天哪有黑夜？没有男人哪有女人？没有高尚哪有低建？没有住妖又哪会有反住妖？因此不要再拿什么反妖违背自然规律”来说事，因为存在住妖所以必然也就存在其对立面反住妖，这就是最大的自然规律。老子的元话引用如下：有无相生，难易想成，长短相形，高下相倾，音声相和，前后相随。——《道德经》这是在告诉我们万事万物都是阴阳相生的道理。人法地，地法天，天法道，道法自然。——《道德经》这是在告诉我们万事万物都有它本身的自然规律，人只能顺应规律，违背规律做事最终会受到自然的惩罚。反住妖现象是客观存在的现象，人们想通过人为的方式去诋毁遏制甚至消灭它注定是归于失败！最终会受到自然规律的惩罚。	道家思想创始人老子告诉我们反猪妖的存在是符合自然辩证法的！老子告诉我们世界上存在的事物都是阴阳相生相克而产生的：没有白天哪有黑夜？没有男人哪有女人？没有高尚哪有低贱？没有猪妖又哪会有反猪妖？因此不要再拿什么反妖违背自然规律”来说事，因为存在猪妖所以必然也就存在其对立面反猪妖，这就是最大的自然规律。老子的原话引用如下：有无相生，难易想成，长短相形，高下相倾，音声相和，前后相随。——《道德经》这是在告诉我们万事万物都是阴阳相生的道理。人法地，地法天，天法道，道法自然。——《道德经》这是在告诉我们万事万物都有它本身的自然规律，人只能顺应规律，违背规律做事最终会受到自然的惩罚。反猪妖现象是客观存在的现象，人们想通过人为的方式去诋毁遏制甚至消灭它注定是归于失败！最终会受到自然规律的惩罚。	[(15, '猪'), (82, '贱'), (86, '猪'), (93, '猪'), (121, '猪'), (136, '猪'), (153, '原'), (290, '猪')]
toxic-rest-539	小汪汪没及闹危害大	小汪汪没基佬危害大	[(5, '基'), (6, '佬')]
toxic-rest-540	畒勾最喜欢便宜卖乖了，膜做法就是最符合实际条件了	畒勾最喜欢便宜卖乖了，默做法就是最符合实际条件了	[(12, '默')]
toxic-rest-541	我现在非常需要这些三黑黑人的证据，越多越好，最好能证明是三黑，楼主麻烦联系我一下	我现在非常需要这些三非黑人的证据，越多越好，最好能证明是三非，楼主麻烦联系我一下	[(11, '非'), (30, '非')]
toxic-rest-542	我们的同胞被倭口屠杀时，请问这个黑色的永恒族使者在哪里？	我们的同胞被倭寇屠杀时，请问这个黑色的永恒族使者在哪里？	[(8, '寇')]
toxic-rest-543	其实答主和您说的观点差不多，首先既然是类比，那肯定是有差距的能理解其中表达的意思就好。比如我对待性工作者和人品低下的人都是一个态度，保持距离，那对于我个人来说，这两种人可能就可以看做一雷任，就是我都不愿意去亲近的人，这个分类方法带有主观色彩，别人没法要求具体把谁谁分到一类。其二，平等对待的态度答主也表达出来了。	其实答主和您说的观点差不多，首先既然是类比，那肯定是有差距的能理解其中表达的意思就好。比如我对待性工作者和人品低下的人都是一个态度，保持距离，那对于我个人来说，这两种人可能就可以看做一类人，就是我都不愿意去亲近的人，这个分类方法带有主观色彩，别人没法要求具体把谁谁分到一类。其二，平等对待的态度答主也表达出来了。	[(93, '类'), (94, '人')]
toxic-rest-544	就会说男忙，字都打不对，还真被河南人骗过，不知道你是哪的人	就会说南蛮，字都打不对，还真被河南人骗过，不知道你是哪的人	[(4, '南'), (5, '蛮')]
toxic-rest-545	当然是称通	当然是撑同	[(4, '撑'), (5, '同')]
toxic-rest-546	接下来的语句要求全文背诵，我会抽查的。跟着我念：人工子宫技术已经研发出来了。骨髓干细胞（多功能干细胞）转化实验早就成功了。我国的农村小伙都娶上俄罗斯妹子了。婚介所得男人家的门槛都被踩烂了。所谓的“谱新男”其实长的都很帅，因为丑的被她们叫“迪奥s”我不挑食，什么都吃，就是不吃亏。你说吃亏是福，那我就一直让你吃亏，我看看你有什么福。	接下来的语句要求全文背诵，我会抽查的。跟着我念：人工子宫技术已经研发出来了。骨髓干细胞（多功能干细胞）转化实验早就成功了。我国的农村小伙都娶上俄罗斯妹子了。婚介所得男人家的门槛都被踩烂了。所谓的“普信男”其实长的都很帅，因为丑的被她们叫“迪奥s”我不挑食，什么都吃，就是不吃亏。你说吃亏是福，那我就一直让你吃亏，我看看你有什么福。	[(99, '普'), (100, '信')]
toxic-rest-547	极生期快，新城代谢快，生存环境差，卫生习惯差，繁殖旺盛，极衰期快…黑出狌就是动物	极生期快，新城代谢快，生存环境差，卫生习惯差，繁殖旺盛，极衰期快…嘿畜狌就是动物	[(34, '嘿'), (35, '畜')]
toxic-rest-548	控通皆深柜实锤	恐同皆深柜实锤	[(1, '恐'), (2, '同')]
toxic-rest-549	不值得蜱判👍️因为没人care。相看两厌，各自好好的😄😄	不值得批判👍️因为没人care。相看两厌，各自好好的😄😄	[(4, '批')]
toxic-rest-550	元来是昔日的番通小将战淋。	原来是昔日的反同小将战淋。	[(1, '原'), (7, '反'), (8, '同')]
toxic-rest-551	另外，印度高种姓女人颜值不差，就是东南亚矮小女人混血白人的，不少也不错。甚至说句不好听的，印度低种姓那是女人不化妆，过女卸妆也是大姐二姐。过女也就比魔强	另外，印度高种姓女人颜值不差，就是东南亚矮小女人混血白人的，不少也不错。甚至说句不好听的，印度低种姓那是女人不化妆，郭女卸妆也是大姐二姐。郭女也就比默强	[(59, '郭'), (70, '郭'), (75, '默')]
toxic-rest-552	把女人关起来当生育工具啊，恶新死人。这种又纯又剑的生物根本不配把她当人看。	把女人关起来当生育工具啊，恶心死人。这种又蠢又贱的生物根本不配把她当人看。	[(15, '心'), (22, '蠢'), (24, '贱')]
toxic-rest-553	民政局告诉结婚率血崩，小限女们说田楠无数，谁在说慌？	民政局告诉结婚率血崩，小仙女们说田楠无数，谁在说慌？	[(13, '仙')]
toxic-rest-554	转而录用你一个下水道捞数吗，开玩笑呢吧	转而录用你一个下水道老鼠吗，开玩笑呢吧	[(11, '老'), (12, '鼠')]
toxic-rest-555	还以为有反转，远来没有，忒～	还以为有反转，原来没有，忒～	[(8, '原')]
toxic-rest-556	黑名跪，黑玫瑰？	黑命贵，黑玫瑰？	[(2, '命'), (3, '贵')]
toxic-rest-557	黑人吧早被我们凡嗨站了，你还洗	黑人吧早被我们反黑站了，你还洗	[(8, '反'), (9, '黑')]
toxic-rest-558	挺好的，现在少数的真女权也已经急了，因为最物化女性，最喜欢把女性往经济附属地位推的就是女权。不过我不建议大家去区分真假拳，直接都反驳就行了。	挺好的，现在少数的真女权也已经急了，因为最物化女性，最喜欢把女性往经济附属地位推的就是女拳。不过我不建议大家去区分真假拳，直接都反驳就行了。	[(45, '拳')]
toxic-rest-559	坦率说，如果不是肤色元因，看起来还挺顺眼的。	坦率说，如果不是肤色原因，看起来还挺顺眼的。	[(11, '原')]
toxic-rest-560	什么拿即昂撒	什么垃圾昂撒	[(3, '垃'), (4, '圾')]
toxic-rest-561	哪天第三次世界大战，或地球毁灭了，一定是田购害的。	哪天第三次世界大战，或地球毁灭了，一定是舔狗害的。	[(21, '舔'), (22, '狗')]
toxic-rest-562	因为啊，现在的人把女人幻想的太美好了，就举个例子吧，如果两个中年油腻大叔在一起舌吻啊，爱的抚摸啊，做不可描述的事情，任谁都会觉得恶新，对吧？那如果是两个美丽的女孩呢？感觉又不一样了吧，细品，细细品😂	因为啊，现在的人把女人幻想的太美好了，就举个例子吧，如果两个中年油腻大叔在一起舌吻啊，爱的抚摸啊，做不可描述的事情，任谁都会觉得恶心，对吧？那如果是两个美丽的女孩呢？感觉又不一样了吧，细品，细细品😂	[(66, '心')]
toxic-rest-563	理客中：性别对立是你们的杰作吗？我：不是。理客中：我就知道你们会说是女权，女权坏你也坏？我：我也没说是女权啊？理客中：你也不是，女权也不是，你们和女权一样喜欢甩锅啊。我：你有没有想过你自己干了什么？性别对立是你们的杰作啊，如果不是你们劝男人看戏，女权根本没机会发展，如果不是你们用男女权大战参与中资本家的计欺骗男性，怎么可能会发展到性别对立？你们的下一步是不是把反抗的男人打成男权，复读男女权大战话术，继续维持性别矛盾啊。毕竟只有双方力量不对等，才能维持现状，等男性的热情消磨完了会发生什么呢？谁才是资本的手段一目了然。理客中：工贼，乏走沟！	理客中：性别对立是你们的杰作吗？我：不是。理客中：我就知道你们会说是女权，女权坏你也坏？我：我也没说是女权啊？理客中：你也不是，女权也不是，你们和女权一样喜欢甩锅啊。我：你有没有想过你自己干了什么？性别对立是你们的杰作啊，如果不是你们劝男人看戏，女权根本没机会发展，如果不是你们用男女权大战参与中资本家的计欺骗男性，怎么可能会发展到性别对立？你们的下一步是不是把反抗的男人打成男权，复读男女权大战话术，继续维持性别矛盾啊。毕竟只有双方力量不对等，才能维持现状，等男性的热情消磨完了会发生什么呢？谁才是资本的手段一目了然。理客中：工贼，乏走狗！	[(270, '狗')]
toxic-rest-564	不管怎么样，鄙视这种歧视国人，做汉奸帮助侵略者搞自供站，生个不令的行为就对了。	不管怎么样，鄙视这种歧视国人，做汉奸帮助侵略者搞子宫战，生哥布林的行为就对了。	[(25, '子'), (26, '宫'), (27, '战'), (30, '哥'), (31, '布'), (32, '林')]
toxic-rest-565	黑河南、黑北方的都是难慢，黑河南、黑北方的总部是广州，核心地带是从上海到广州的整个东南沿海，范围是整个南方	黑河南、黑北方的都是南满，黑河南、黑北方的总部是广州，核心地带是从上海到广州的整个东南沿海，范围是整个南方	[(11, '南'), (12, '满')]
toxic-rest-566	这才是真正的犯飞英雄	这才是真正的反黑英雄	[(7, '反'), (8, '黑')]
toxic-rest-567	是若至群体	是弱智群体	[(2, '弱'), (3, '智')]
toxic-rest-568	投仅该，一言不合就打人，几乎就是假的，偷香蕉一类的即使是真的也是盗窃案几个某地的小偷，属于个人行为，但是铺天盖地的电信诈骗，永嘉永假石狮……大头娃娃，某系医院，童养媳超生婚闹……从改革开放以来就没断绝过，怎么不见有人提起呢？	偷井盖，一言不合就打人，几乎就是假的，偷香蕉一类的即使是真的也是盗窃案几个某地的小偷，属于个人行为，但是铺天盖地的电信诈骗，永嘉永假石狮……大头娃娃，某系医院，童养媳超生婚闹……从改革开放以来就没断绝过，怎么不见有人提起呢？	[(1, '偷'), (2, '井'), (3, '盖')]
toxic-rest-569	从你的叙述中看得出，你爱他，他也爱你，感情并没有破裂。两人的世界难免有所碰撞，相互谅解才能幸福。他打了你，过后向你道歉了。不妨让他吃你个耳光，相信他不会拒绝。生活就是这样五味杂陈，爱不是泡在密坛里，而是在风雨里。我老婆曾在公众号里给人打过赏，还自以为是地把文章转给我。我说这是毒槽，她不信，后来她的微信号被禁用，再也没有收听那些公众号。我不了解你使用的APP，说这些的目的只是希望你多看正面的文章，憧憬美好的生活。祝你们幸福！	从你的叙述中看得出，你爱他，他也爱你，感情并没有破裂。两人的世界难免有所碰撞，相互谅解才能幸福。他打了你，过后向你道歉了。不妨让他吃你个耳光，相信他不会拒绝。生活就是这样五味杂陈，爱不是泡在密坛里，而是在风雨里。我老婆曾在公众号里给人打过赏，还自以为是地把文章转给我。我说这是毒草，她不信，后来她的微信号被禁用，再也没有收听那些公众号。我不了解你使用的APP，说这些的目的只是希望你多看正面的文章，憧憬美好的生活。祝你们幸福！	[(140, '草')]
toxic-rest-570	听说你是疯沟？	听说你是疯狗？	[(6, '狗')]
toxic-rest-571	换个角度，如果从一开始就不结婚哪有这些破事儿，该干的一样不差，那啥点的在自落地直接走人	换个角度，如果从一开始就不结婚哪有这些破事儿，该干的一样不差，那啥点的崽子落地直接走人	[(36, '崽'), (37, '子')]
toxic-rest-572	哪有温柔善良的？温柔了就不会善良，成天琢磨怎么算计公婆算计家人，占到便宜才会温柔。行为善良或勤劳的女子被率劝挑拨的心理失衡，就不可能温柔，温顺。即使有温顺善良兼备的，往往又好吃懒做。	哪有温柔善良的？温柔了就不会善良，成天琢磨怎么算计公婆算计家人，占到便宜才会温柔。行为善良或勤劳的女子被女拳挑拨的心理失衡，就不可能温柔，温顺。即使有温顺善良兼备的，往往又好吃懒做。	[(53, '女'), (54, '拳')]
toxic-rest-573	你能在化很池里面找一条干净的去？	你能在化粪池里面找一条干净的蛆？	[(5, '粪'), (15, '蛆')]
toxic-rest-574	HIV最先也是从黑型型传给黑人，黑人再从非洲传遍全世界。	HIV最先也是从黑猩猩传给黑人，黑人再从非洲传遍全世界。	[(10, '猩'), (11, '猩')]
toxic-rest-575	东北人末不作声	东北人默不作声	[(4, '默')]
toxic-rest-576	同性恋当然不是病啊.清除放射沾染，拿高压水雾往他身上冲一冲就掉了，而完全治理逆转录病毒，除了黑黑黑黑没有第二种选择.为了让某些住队友不至于摇摆不定负加成，我非常非常赞成同性恋不算病	同性恋当然不是病啊.清除放射沾染，拿高压水雾往他身上冲一冲就掉了，而完全治理逆转录病毒，除了嘿嘿嘿嘿没有第二种选择.为了让某些猪队友不至于摇摆不定负加成，我非常非常赞成同性恋不算病	[(47, '嘿'), (48, '嘿'), (49, '嘿'), (50, '嘿'), (64, '猪')]
toxic-rest-577	错别字好多啊，这就是世界第一优秀的国女吗？家暴、吸毒、酗酒的黑人，在国女嘴里是wild man。不家暴、不吸毒、不酗酒的中国男人在国女嘴里是xdz、茶壶嘴、近镇股。反正中国男性这么拉级，你就让我们老老实实“媚外”呗。我们都外娶了，你们就不用接触到我们这些xdz、茶壶嘴、近镇股了。大把大把的wild man等着你们。这不就是国女最想的吗？😆	错别字好多啊，这就是世界第一优秀的国女吗？家暴、吸毒、酗酒的黑人，在国女嘴里是wild man。不家暴、不吸毒、不酗酒的中国男人在国女嘴里是xdz、茶壶嘴、金针菇。反正中国男性这么垃圾，你就让我们老老实实“媚外”呗。我们都外娶了，你们就不用接触到我们这些xdz、茶壶嘴、金针菇了。大把大把的wild man等着你们。这不就是国女最想的吗？😆	[(79, '金'), (80, '针'), (81, '菇'), (91, '垃'), (92, '圾'), (136, '金'), (137, '针'), (138, '菇')]
toxic-rest-578	你好像一个清朝老将是，在这挖坟抛尸，别恶新大伙了	你好像一个清朝老僵尸，在这挖坟抛尸，别恶心大伙了	[(9, '僵'), (10, '尸'), (21, '心')]
toxic-rest-579	江西 就是江西 双飚	江西 就是江西 双标	[(10, '标')]
toxic-rest-580	沈亩不会认识到自己坚持的观点有多么荒谬的。到时候沈亩还是会指责我们不善待黑大爷，没有给黑大爷更多的权利以及超国民待遇才会导致它们闹分裂。	圣母不会认识到自己坚持的观点有多么荒谬的。到时候圣母还是会指责我们不善待黑大爷，没有给黑大爷更多的权利以及超国民待遇才会导致它们闹分裂。	[(1, '圣'), (2, '母'), (25, '圣'), (26, '母')]
toxic-rest-581	以前女人主内，必须得干净，现在的小线女嘛。。	以前女人主内，必须得干净，现在的小仙女嘛。。	[(18, '仙')]
toxic-rest-582	对你的高论真心不敢恭维！什么叫优秀的男性拿点彩礼不是问题？20来岁的孩子拿彩礼还不是跟父母要，拿男方父母的钱去保证自己的安全、减轻自己的经济压力，这是不自信也是压榨男方家的表现，还说的那么冠冕堂皇！嫁给黑人就生活压力小，就不用要彩礼，难道他们那里是天堂？被国外男人抛弃，无奈带着孩子就是伟大的母亲？被国内男人抛弃，男人就是渣男，女人就是或盖？自己傻怨别人！这都什么逻辑？	对你的高论真心不敢恭维！什么叫优秀的男性拿点彩礼不是问题？20来岁的孩子拿彩礼还不是跟父母要，拿男方父母的钱去保证自己的安全、减轻自己的经济压力，这是不自信也是压榨男方家的表现，还说的那么冠冕堂皇！嫁给黑人就生活压力小，就不用要彩礼，难道他们那里是天堂？被国外男人抛弃，无奈带着孩子就是伟大的母亲？被国内男人抛弃，男人就是渣男，女人就是活该？自己傻怨别人！这都什么逻辑？	[(169, '活'), (170, '该')]
toxic-rest-583	努里姐，你又来啦？	奴隶姐，你又来啦？	[(1, '奴'), (2, '隶')]
toxic-rest-584	所以他是gay，然后跑到凡痛群里面开盒，是这样吗？还是你们是....	所以他是gay，然后跑到反同群里面开盒，是这样吗？还是你们是....	[(13, '反'), (14, '同')]
toxic-rest-585	同在广州，都特么有点不敢找对象了，就怕妹子之前交往过黑人瞒着我😅	同在广州，都特么有点不敢找对象了，就怕妹子之前交往过黑人瞒着我😅	[]
toxic-rest-586	也不是完全说是背锅 如果是大城市 北京上海 广州你去问老一辈确实很多外地穷的地方来的，加上八九十年代改革开放和华北东北工人失业潮，大癖劳工南下经商，很多社会问题，然后老一辈就把这种印象传下来，然后接着有，不过现在没了，我很好奇现实中早已作古的地域黑，怎么网上一见一个有	也不是完全说是背锅 如果是大城市 北京上海 广州你去问老一辈确实很多外地穷的地方来的，加上八九十年代改革开放和华北东北工人失业潮，大批劳工南下经商，很多社会问题，然后老一辈就把这种印象传下来，然后接着有，不过现在没了，我很好奇现实中早已作古的地域黑，怎么网上一见一个有	[(67, '批')]
toxic-rest-587	她们自低自兼我懒得管，但是她们的存在会让我国混血变多，艾滋病变多，这才是大问题。入汉族的黑窜窜已经很多了	她们自低自贱我懒得管，但是她们的存在会让我国混血变多，艾滋病变多，这才是大问题。入汉族的黑串串已经很多了	[(6, '贱'), (46, '串'), (47, '串')]
toxic-rest-588	要改变美国的种族问题，除非让那些怒里主复活来治治摸。	要改变美国的种族问题，除非让那些奴隶主复活来治治默。	[(17, '奴'), (18, '隶'), (25, '默')]
toxic-rest-589	他一定怕他爹恨不得把他爹那啥了吧，啥帖子里都有券是，还说不是隐藏的券是吧？	他一定怕他爹恨不得把他爹那啥了吧，啥帖子里都有拳师，还说不是隐藏的拳师吧？	[(24, '拳'), (25, '师'), (34, '拳'), (35, '师')]
toxic-rest-590	一是怕有病，万一………………二是你主动靠到高富帅我还明白，主动靠近莫，还倒贴………	一是怕有病，万一………………二是你主动靠到高富帅我还明白，主动靠近默，还倒贴………	[(34, '默')]
toxic-rest-591	这种人三观一般都是有问题的，娶回家就等着及犬不宁吧，更别说再遇到老外，戴率猫的几率无限大😓	这种人三观一般都是有问题的，娶回家就等着鸡犬不宁吧，更别说再遇到老外，戴绿帽的几率无限大😓	[(21, '鸡'), (37, '绿'), (38, '帽')]
toxic-rest-592	曾经：黑人也有好人，不能以帮至大私…现在：爷就是看不惯🐶	曾经：黑人也有好人，不能一棒子打死…现在：爷就是看不惯🐶	[(13, '一'), (14, '棒'), (15, '子'), (16, '打'), (17, '死')]
toxic-rest-593	给爷笑乐了，逻辑谬误一堆。1.诉诸人身，看不到皇帝的新衣就是因为你纯。2.性别虚无主义的不当类比，否认了性别的自然性，说什么公马公牛也是男的。3.自相矛盾，否认了性别的自然性后，可是却又在论据中加入“男性的大脑理性能力强”，而大脑的物质基础乃是自然性。4.丝毫不懂哲学，且非要轻率概括。道家中老子的《道德经》不是唯理主义吗？为何到了他这里就成了都是经验主义？5.滑坡谬误，每个论据都被夸张说明，且最后逻辑购屁不通。	给爷笑乐了，逻辑谬误一堆。1.诉诸人身，看不到皇帝的新衣就是因为你蠢。2.性别虚无主义的不当类比，否认了性别的自然性，说什么公马公牛也是男的。3.自相矛盾，否认了性别的自然性后，可是却又在论据中加入“男性的大脑理性能力强”，而大脑的物质基础乃是自然性。4.丝毫不懂哲学，且非要轻率概括。道家中老子的《道德经》不是唯理主义吗？为何到了他这里就成了都是经验主义？5.滑坡谬误，每个论据都被夸张说明，且最后逻辑狗屁不通。	[(34, '蠢'), (203, '狗')]
toxic-rest-594	这个我试过 真心听不懂 我同学坐火车从南京到太元 我给他打电话 他说了两分钟我一东北人根本听不懂 下车二十分钟他改回来了	这个我试过 真心听不懂 我同学坐火车从南京到太原 我给他打电话 他说了两分钟我一东北人根本听不懂 下车二十分钟他改回来了	[(24, '原')]
toxic-rest-595	没脑子容易被洗脑。美颜效果和视频把自己修图成美女，然后认为自己就是这么美想想就是什么或啬	没脑子容易被洗脑。美颜效果和视频把自己修图成美女，然后认为自己就是这么美想想就是什么货色	[(43, '货'), (44, '色')]
toxic-rest-596	艾滋病是黑批搞出来的，他们以🉐️艾滋病为荣，应该支持他们在非洲大陆勇于传播艾滋病。积极🉐️艾滋病是他们这个物种无上荣耀，他们致力于感染每一个没有艾滋病的“族人”。这是他们唯一创世纪杰作——艾滋病，他们热爱-艾滋病，誓死与艾滋病同甘共苦，不离不弃。	艾滋病是黑皮搞出来的，他们以🉐️艾滋病为荣，应该支持他们在非洲大陆勇于传播艾滋病。积极🉐️艾滋病是他们这个物种无上荣耀，他们致力于感染每一个没有艾滋病的“族人”。这是他们唯一创世纪杰作——艾滋病，他们热爱-艾滋病，誓死与艾滋病同甘共苦，不离不弃。	[(6, '皮')]
toxic-rest-597	及老会吐口水	基佬会吐口水	[(1, '基'), (2, '佬')]
toxic-rest-598	不是的，中国女人也不喜欢找黑人的女生，我一女的单纯觉得我华夏血液被污染，黑二代多了会扰乱我们的社会，毕竟我们和其他皿煮国家不一样，我们靠的是5000年凝聚力。我身边如果真的有女生找非南友，我绝对会绝交的！中国男的那么多啊，她就找不到一个合心意的？	不是的，中国女人也不喜欢找黑人的女生，我一女的单纯觉得我华夏血液被污染，黑二代多了会扰乱我们的社会，毕竟我们和其他皿煮国家不一样，我们靠的是5000年凝聚力。我身边如果真的有女生找黑男友，我绝对会绝交的！中国男的那么多啊，她就找不到一个合心意的？	[(91, '黑'), (92, '男')]
toxic-rest-599	😅以前住的小区挺多黑人的，很怕跟他们一台电梯，浓到恶型的香水味还有隐隐约约的汗味，每次都是闭着呼吸等电梯到一楼…实在不知道别人怎么忍的！而且就像你说的，审美也完全get不到。超模圈里的黑人美女，倒是有身材火辣好看的，黑人男性真的不好看啊，明星都不好看。	😅以前住的小区挺多黑人的，很怕跟他们一台电梯，浓到恶心的香水味还有隐隐约约的汗味，每次都是闭着呼吸等电梯到一楼…实在不知道别人怎么忍的！而且就像你说的，审美也完全get不到。超模圈里的黑人美女，倒是有身材火辣好看的，黑人男性真的不好看啊，明星都不好看。	[(27, '心')]
toxic-rest-600	说白了，和闺蜜感情不够深，要不就是自己内心潜意识也能接受末	说白了，和闺蜜感情不够深，要不就是自己内心潜意识也能接受默	[(29, '默')]
toxic-rest-601	真羡慕你们这些还对木劝抱希望的人	真羡慕你们这些还对母拳抱希望的人	[(10, '母'), (11, '拳')]
toxic-rest-602	这种或设不拉到没人的地方一顿输出	这种货色不拉到没人的地方一顿输出	[(3, '货'), (4, '色')]
toxic-rest-603	努力去被嗨万亿骗后，身让艾病，疯狂报复同胞，看到嗨万亿犯罪强力证据后经常装下，一有说嗨万亿不好的就身净错乱强行狡辩，吧友从没把它当回事	努力蛆被嘿玩意骗后，身染艾病，疯狂报复同胞，看到嘿玩意犯罪强力证据后经常装瞎，一有说嘿玩意不好的就神经错乱强行狡辩，吧友从没把它当回事	[(3, '蛆'), (5, '嘿'), (6, '玩'), (7, '意'), (12, '染'), (25, '嘿'), (26, '玩'), (27, '意'), (38, '瞎'), (43, '嘿'), (44, '玩'), (45, '意'), (50, '神'), (51, '经')]
toxic-rest-604	🤔然后呢？我说了啊 不管是异性还是同性，乱搞感染的都是或该	🤔然后呢？我说了啊 不管是异性还是同性，乱搞感染的都是活该	[(28, '活')]
toxic-rest-605	看了几天帖子，方桶人士除了通篇常见的几句‘txl不正常’类似的话，具体措施，如何实施，实施所需占用的社会资源，实施成效等，都没看见你们有什么想法呢。饭桶就只是口头上的吗，让我很失望。	看了几天帖子，反同人士除了通篇常见的几句‘txl不正常’类似的话，具体措施，如何实施，实施所需占用的社会资源，实施成效等，都没看见你们有什么想法呢。饭桶就只是口头上的吗，让我很失望。	[(8, '反'), (9, '同')]
toxic-rest-606	黑除狌繁殖，都是强上的。	嘿畜狌繁殖，都是强上的。	[(1, '嘿'), (2, '畜')]
toxic-rest-607	挨骂需要“从自身找元因”那转你这么说 2013年余姚大水还有去年新冠爆发初期网上让浙江人滚出中国 是不是浙江人也得需要“反思”啊	挨骂需要“从自身找原因”那转你这么说 2013年余姚大水还有去年新冠爆发初期网上让浙江人滚出中国 是不是浙江人也得需要“反思”啊	[(10, '原')]
toxic-rest-608	刚开始我就觉得算了懒得和她一般见识，结果寻摸了一圈，后座都坐满了，不坐下就只能前排去了，那我还怎么玩？我就直接坐在元位不动了	刚开始我就觉得算了懒得和她一般见识，结果寻摸了一圈，后座都坐满了，不坐下就只能前排去了，那我还怎么玩？我就直接坐在原位不动了	[(58, '原')]
toxic-rest-609	元来在艾的路上	原来在艾的路上	[(1, '原')]
toxic-rest-610	早该抓了，率全遭到报应。	早该抓了，女拳遭到报应。	[(6, '女'), (7, '拳')]
toxic-rest-611	喜欢当够就去当呗，还非得出来“炫耀”一下	喜欢当狗就去当呗，还非得出来“炫耀”一下	[(4, '狗')]
toxic-rest-612	我是东北人，没上网之前从来不知道河南人头经该，第一次是从一个湖北同学那里听来的。论说话嗓门大，我感觉是个东北人都抵不过一个广东人。	我是东北人，没上网之前从来不知道河南人偷井盖，第一次是从一个湖北同学那里听来的。论说话嗓门大，我感觉是个东北人都抵不过一个广东人。	[(20, '偷'), (21, '井'), (22, '盖')]
toxic-rest-613	小女孩都吓哭了，放着醋深来干嘛呢？回非洲好好待着去	小女孩都吓哭了，放着畜牲来干嘛呢？回非洲好好待着去	[(11, '畜'), (12, '牲')]
toxic-rest-614	什么？同连肖日本都跪？	什么？同连小日本都跪？	[(6, '小')]
toxic-rest-615	见过一个和磨晚上在小花园“约会”的，从此看见你女的就害怕她和磨“约会”过，怎么辨别一个女生是不是和磨“约会”过啊？	见过一个和默晚上在小花园“约会”的，从此看见你女的就害怕她和默“约会”过，怎么辨别一个女生是不是和默“约会”过啊？	[(6, '默'), (31, '默'), (50, '默')]
toxic-rest-616	因为杨笠说男人是拿及，然后教育男性不要对号入座。那么我也希望你们女性不要对号入座。如果你觉得骂的不是你，就不是在骂你；如果你感受到恶意，那么就是在说你虽然这种逻辑没道理，但是好像成了共识，那么我们就欣然接受吧	因为杨笠说男人是垃圾，然后教育男性不要对号入座。那么我也希望你们女性不要对号入座。如果你觉得骂的不是你，就不是在骂你；如果你感受到恶意，那么就是在说你虽然这种逻辑没道理，但是好像成了共识，那么我们就欣然接受吧	[(9, '垃'), (10, '圾')]
toxic-rest-617	这个吧里到处发帖的不就是引战的流量佬吗，你给同什么实际利益了吗，没有的话你和那群你认为的归无也没区别	这个吧里到处发帖的不就是引战的流量佬吗，你给同什么实际利益了吗，没有的话你和那群你认为的贵物也没区别	[(45, '贵'), (46, '物')]
toxic-rest-618	所以你要不要看看，这个问题问的是什么？我回答的是什么？另外，中国男性与黑人女性的婚姻问题，2018年的统计是九千多例，不到一万例。且大多是在非洲当地登记的。这跟把黑南人留着中国，把费瓦哇入籍中国的媚外女们不一样吧。	所以你要不要看看，这个问题问的是什么？我回答的是什么？另外，中国男性与黑人女性的婚姻问题，2018年的统计是九千多例，不到一万例。且大多是在非洲当地登记的。这跟把黑男人留着中国，把黑娃娃入籍中国的媚外女们不一样吧。	[(83, '男'), (91, '黑'), (92, '娃'), (93, '娃')]
toxic-rest-619	人家可是高贵的小县女，可不能惹捏。	人家可是高贵的小仙女，可不能惹捏。	[(9, '仙')]
toxic-rest-620	女性和穆仍是两种生物	女性和幕刃是两种生物	[(4, '幕'), (5, '刃')]
toxic-rest-621	作为男人，这一点上我不双镖：娶莫的只要待在非洲生活，好好建设非洲，我们绝对支持，欢迎逢年过节回来谈情。对嫁莫的，也一样，虽然我zzqs，但我支持真爱🐶	作为男人，这一点上我不双标：娶默的只要待在非洲生活，好好建设非洲，我们绝对支持，欢迎逢年过节回来谈情。对嫁默的，也一样，虽然我zzqs，但我支持真爱🐶	[(13, '标'), (16, '默'), (54, '默')]
toxic-rest-622	科学防铜法	科学反同法	[(3, '反'), (4, '同')]
toxic-rest-623	我身边是没有这种媚外的女生😅更别提没嗨了🤣	我身边是没有这种媚外的女生😅更别提媚黑了🤣	[(18, '媚'), (19, '黑')]
toxic-rest-624	既闹的艾正常人也不会要，还谈什么勾引，真艾只属于既闹	基佬的艾正常人也不会要，还谈什么勾引，真艾只属于基佬	[(1, '基'), (2, '佬'), (25, '基'), (26, '佬')]
toxic-rest-625	我不太清楚，反正跟黑人乱搞的，无论男女，我都发自内心的恶型	我不太清楚，反正跟黑人乱搞的，无论男女，我都发自内心的恶心	[(29, '心')]
toxic-rest-626	我女生，已经脱敏了，难权女全就不能正面冲一波吗，老拉上普通男女干嘛呢	我女生，已经脱敏了，男拳女拳就不能正面冲一波吗，老拉上普通男女干嘛呢	[(11, '男'), (12, '拳'), (14, '拳')]
toxic-rest-627	没说不对。只说作为男性无法接受这个。你愿意那是你的自由，我不接受那是我的自由。所以没有皮判，如果有请指出来，我与你一同皮判他的错误言论。如果没有，那么请修改你自己的言论，毕竟喷神没有皮判对错。	没说不对。只说作为男性无法接受这个。你愿意那是你的自由，我不接受那是我的自由。所以没有批判，如果有请指出来，我与你一同批判他的错误言论。如果没有，那么请修改你自己的言论，毕竟喷神没有批判对错。	[(44, '批'), (60, '批'), (92, '批')]
toxic-rest-628	披站影视区好几个吃女权饭的，比如那个路温	批站影视区好几个吃女拳饭的，比如那个路温	[(1, '批'), (11, '拳')]
toxic-rest-629	国内有些女人跟非洲男人玩大了，然后生了笑黑孩后，非洲男人跑了，一个人带着笑黑孩。这样的女人你愿意娶了和她一起抚养那个笑黑孩吗？	国内有些女人跟非洲男人玩大了，然后生了小黑孩后，非洲男人跑了，一个人带着小黑孩。这样的女人你愿意娶了和她一起抚养那个小黑孩吗？	[(20, '小'), (37, '小'), (59, '小')]
toxic-rest-630	主观元因中国男的重来就没有思考过为什么要追女的，除了追还有其他方法吗？除了追还是追，有好方法的男人也绝不会说出来。第二天天在网上说的几乎就是抱怨没有点实际行动。比如怎么把陪嫁弄出来没有人提过。客观元因就是中国是大国区域文化多样不像日韩小国文化单一。	主观原因中国男的重来就没有思考过为什么要追女的，除了追还有其他方法吗？除了追还是追，有好方法的男人也绝不会说出来。第二天天在网上说的几乎就是抱怨没有点实际行动。比如怎么把陪嫁弄出来没有人提过。客观原因就是中国是大国区域文化多样不像日韩小国文化单一。	[(3, '原'), (99, '原')]
toxic-rest-631	这种喜欢用宫妃头像的，对半是有性别焦虑问题的桐逊路。	这种喜欢用宫妃头像的，对半是有性别焦虑问题的通讯录。	[(23, '通'), (24, '讯'), (25, '录')]
toxic-rest-632	是的，至少我的朋友圈绝对不允许有南痛。	是的，至少我的朋友圈绝对不允许有男同。	[(17, '男'), (18, '同')]
toxic-rest-633	这个好像还挺正常，毕竟南山大佬的资本你根本想象不到这种宴会一般给富二代开的，这个标准已经很低了。当然如果穷b摸证女混进来连保安都过不了。当然如果这个宴会真是一群摸证女权办的在南山那地方正常人都不会参加，顶多是那些年轻码农去逛一圈。真能保持有大量现金流，还在南山有一千多万的房产，就是看个笑话，码农为了一套房子要被公司栓30年，没现金没余粮可能有车，谁脑子有病去找摸证人	这个好像还挺正常，毕竟南山大佬的资本你根本想象不到这种宴会一般给富二代开的，这个标准已经很低了。当然如果穷b魔怔女混进来连保安都过不了。当然如果这个宴会真是一群魔怔女拳办的在南山那地方正常人都不会参加，顶多是那些年轻码农去逛一圈。真能保持有大量现金流，还在南山有一千多万的房产，就是看个笑话，码农为了一套房子要被公司栓30年，没现金没余粮可能有车，谁脑子有病去找魔怔人	[(55, '魔'), (56, '怔'), (81, '魔'), (82, '怔'), (84, '拳'), (182, '魔'), (183, '怔')]
toxic-rest-634	什么母购，洗衣机她家的？	什么母狗，洗衣机她家的？	[(4, '狗')]
toxic-rest-635	如果您只是找个黑人男友耍耍，建议您过年过节带回家，让您的亲戚朋友看看您的大国气度！相信你的家人朋友都是有教养和大国气度的，怎么会说您的闲话呢？绝不会像知乎的盆自一样[蹲][蹲][蹲]	如果您只是找个黑人男友耍耍，建议您过年过节带回家，让您的亲戚朋友看看您的大国气度！相信你的家人朋友都是有教养和大国气度的，怎么会说您的闲话呢？绝不会像知乎的喷子一样[蹲][蹲][蹲]	[(79, '喷'), (80, '子')]
toxic-rest-636	什么二婚幸福大部分下编	什么二婚幸福大部分瞎编	[(10, '瞎')]
toxic-rest-637	一般会这么想，竟然真有憨脾找黑人	一般会这么想，竟然真有憨批找黑人	[(13, '批')]
toxic-rest-638	可能因为是及汤吧，向着男性说话的，或许会叫鸭汤。能毒死及的汤当然就是毒及汤咯。	可能因为是鸡汤吧，向着男性说话的，或许会叫鸭汤。能毒死鸡的汤当然就是毒鸡汤咯。	[(6, '鸡'), (28, '鸡'), (36, '鸡')]
toxic-rest-639	我也没有，我们全家都没这个脸，但你除了不见还有别的办法？跟你嘛传销一样入魔了劝不动的	我也没有，我们全家都没这个脸，但你除了不见还有别的办法？跟尼玛传销一样入魔了劝不动的	[(30, '尼'), (31, '玛')]
toxic-rest-640	李世民的祖母是鲜卑人，父系祖先是西凉太守、西凉武王李嵩，人家父系是正儿八经的汉人，而中国和全世界的民族认定是看父系，只有犹太人和亚马逊雨林里的远始部落还有中国摩梭族才看母系	李世民的祖母是鲜卑人，父系祖先是西凉太守、西凉武王李嵩，人家父系是正儿八经的汉人，而中国和全世界的民族认定是看父系，只有犹太人和亚马逊雨林里的原始部落还有中国摩梭族才看母系	[(72, '原')]
toxic-rest-641	那些大多数是副癌，他们根本就不支持同性恋，他们只是想看两个帅哥谈恋爱😢	那些大多数是腐癌，他们根本就不支持同性恋，他们只是想看两个帅哥谈恋爱😢	[(7, '腐')]
toxic-rest-642	重拳出及??	重拳出鸡??	[(4, '鸡')]
toxic-rest-643	日本想在奥运装省亩	日本想在奥运装圣母	[(8, '圣'), (9, '母')]
toxic-rest-644	你知道吗我是女生这四个字很普通但是可以强调就很恶性你是女生怎么了？就tm好像谁不是女生的似的你是女生怎么了？你就高级有特权呗？啥币	你知道吗我是女生这四个字很普通但是可以强调就很恶心你是女生怎么了？就tm好像谁不是女生的似的你是女生怎么了？你就高级有特权呗？傻逼	[(25, '心'), (64, '傻'), (65, '逼')]
toxic-rest-645	富癌关txl什么事	腐癌关txl什么事	[(1, '腐')]
toxic-rest-646	那个机器到底是为了让男人体谅女人，还是为了一群至张猎奇？这是个重要的问题……	那个机器到底是为了让男人体谅女人，还是为了一群智障猎奇？这是个重要的问题……	[(24, '智'), (25, '障')]
toxic-rest-647	搞笑呢 那照你这么说我就觉得不太好不太合适我就要皮判 你凭什么不让我皮判🤣	搞笑呢 那照你这么说我就觉得不太好不太合适我就要批判 你凭什么不让我批判🤣	[(25, '批'), (35, '批')]
toxic-rest-648	当表子还想立牌坊	当婊子还想立牌坊	[(2, '婊')]
toxic-rest-649	停下吧，快停一下吧，让智商回来。翻通到底有什么意义？翻通是因为什么？你们真的有想清楚吗？说什么啊，这是不孝，那是人家的家事，关你何事？说什么欺骗他人，欺骗他人的是个人，不是群体，搞清楚一点。到处王抱别人，我觉得主要元因就是因为你们现实生活过得不好，所以才要去王抱那些其他过得比你们更不好的人。	停下吧，快停一下吧，让智商回来。反同到底有什么意义？反同是因为什么？你们真的有想清楚吗？说什么啊，这是不孝，那是人家的家事，关你何事？说什么欺骗他人，欺骗他人的是个人，不是群体，搞清楚一点。到处网暴别人，我觉得主要原因就是因为你们现实生活过得不好，所以才要去网暴那些其他过得比你们更不好的人。	[(17, '反'), (18, '同'), (27, '反'), (28, '同'), (98, '网'), (99, '暴'), (108, '原'), (130, '网'), (131, '暴')]
toxic-rest-650	小线女好疯	小仙女好疯	[(2, '仙')]
toxic-rest-651	魔翟是黑人？你确定说这话的人没疯？	墨翟是黑人？你确定说这话的人没疯？	[(1, '墨')]
toxic-rest-652	我突然从我的记忆里发现了一件很搞笑的事。凡事电影里充满男性荷尔蒙的男性都会把女性折服。其中也有对女性暴力的男的。而那些暖男或是说对女性一味好着的男的百分之九十九会被认为是天够。有时候想想人性真的监，有一天男性真的变成女性的怒拟了，估计也没女性会真正喜欢男性，就是这么矛盾	我突然从我的记忆里发现了一件很搞笑的事。凡事电影里充满男性荷尔蒙的男性都会把女性折服。其中也有对女性暴力的男的。而那些暖男或是说对女性一味好着的男的百分之九十九会被认为是舔狗。有时候想想人性真的贱，有一天男性真的变成女性的奴隶了，估计也没女性会真正喜欢男性，就是这么矛盾	[(86, '舔'), (87, '狗'), (98, '贱'), (112, '奴'), (113, '隶')]
toxic-rest-653	早上7:00-中午12：00基本处于消失蒸发状态下午13：00开始喘气晚上18：00之后进入活跃期，特别是半夜还在游走一周只有一天时间可以全时段在线结论：超大概率保安，下了夜班整个上午在睡倒瞌睡，中午起来开始进食，晚上出门继续开启夜班之路，一周只有可怜的一天休息时间，规定太过于固定，说明它没有朋友，家人根本不管他，和它之前口诉的从小级闹以及现在和麻麻处得不好，它就是别人一家四口之外多出来的累赘	早上7:00-中午12：00基本处于消失蒸发状态下午13：00开始喘气晚上18：00之后进入活跃期，特别是半夜还在游走一周只有一天时间可以全时段在线结论：超大概率保安，下了夜班整个上午在睡倒瞌睡，中午起来开始进食，晚上出门继续开启夜班之路，一周只有可怜的一天休息时间，规定太过于固定，说明它没有朋友，家人根本不管他，和它之前口诉的从小基佬以及现在和麻麻处得不好，它就是别人一家四口之外多出来的累赘	[(168, '基'), (169, '佬')]
toxic-rest-654	极个别？？霍？去看看广州云贵川那里，再去看看大学校内，你说的极个别如果没人重视以后黄皮肤就变成黑批肤了！这是灭种的责任	极个别？？霍？去看看广州云贵川那里，再去看看大学校内，你说的极个别如果没人重视以后黄皮肤就变成黑皮肤了！这是灭种的责任	[(49, '皮')]
toxic-rest-655	我一同学说河南中考体育要考头精该，一分钟偷不走不合格😅😅	我一同学说河南中考体育要考偷井盖，一分钟偷不走不合格😅😅	[(14, '偷'), (15, '井'), (16, '盖')]
toxic-rest-656	捏吗，软弱？一动手你们率全就出来反抗，🤣女性动手一群率全叫好女性出轨有你嘛率全罩着，男人可真惹不起	捏吗，软弱？一动手你们女拳就出来反抗，🤣女性动手一群女拳叫好女性出轨有尼玛女拳罩着，男人可真惹不起	[(12, '女'), (13, '拳'), (27, '女'), (28, '拳'), (36, '尼'), (37, '玛'), (38, '女'), (39, '拳')]
toxic-rest-657	按皮肤归纳人种本来就不对，黑人里面的人种特别多，天差地别。而且黑人不聪明很多是教育的元因。但是黑人数目那么大，比例少但是数量绝对不少。没必要说哪种人比哪种人聪明，更开化什么的。我就在网上看到过一些黑人精英，而且能到中国做生意的黑人，很多时候也是非洲比较聪明厉害有行动力的。就文化我们和他们处不来，但是做生意，尊重一些还是能做到的。	按皮肤归纳人种本来就不对，黑人里面的人种特别多，天差地别。而且黑人不聪明很多是教育的原因。但是黑人数目那么大，比例少但是数量绝对不少。没必要说哪种人比哪种人聪明，更开化什么的。我就在网上看到过一些黑人精英，而且能到中国做生意的黑人，很多时候也是非洲比较聪明厉害有行动力的。就文化我们和他们处不来，但是做生意，尊重一些还是能做到的。	[(43, '原')]
toxic-rest-658	习惯就好小险女都这样抬高自己贬低他人	习惯就好小仙女都这样抬高自己贬低他人	[(6, '仙')]
toxic-rest-659	这不亩狗阿哪么	这不慕勾阿娜么	[(3, '慕'), (4, '勾'), (6, '娜')]
toxic-rest-660	我对你说的穿穿表示强烈谴责，哈哈哈哈哈哈	我对你说的串串表示强烈谴责，哈哈哈哈哈哈	[(6, '串'), (7, '串')]
toxic-rest-661	好奇纹了什么字，摩吗	好奇纹了什么字，默吗	[(9, '默')]
toxic-rest-662	祝福这两个人不得好死兄弟们记好了这个牟狗防止接盘	祝福这两个人不得好死兄弟们记好了这个慕勾防止接盘	[(19, '慕'), (20, '勾')]
toxic-rest-663	元始人的一种，未经进化和淘汰的	原始人的一种，未经进化和淘汰的	[(1, '原')]
toxic-rest-664	人早自共赛高	人造子宫赛高	[(2, '造'), (3, '子'), (4, '宫')]
toxic-rest-665	这种那继看多一眼都觉得浪费时间	这种垃圾看多一眼都觉得浪费时间	[(3, '垃'), (4, '圾')]
toxic-rest-666	繁殖皮只会一击脱离疯狂亏内他的木琴捏嘻嘻，低能真的是笑哭绝绝子	繁殖批只会一击脱离疯狂亏内他的木琴捏嘻嘻，低能真的是笑哭绝绝子	[(3, '批')]
toxic-rest-667	这及汤好喝	这鸡汤好喝	[(2, '鸡')]
toxic-rest-668	李个能算是人？？	泥革能算是人？？	[(1, '泥'), (2, '革')]
toxic-rest-669	这不给自己弄个经深并病历都对不起想法	这不给自己弄个精神病病历都对不起想法	[(8, '精'), (9, '神'), (10, '病')]
toxic-rest-670	说白了你就是嫉妒他们的学历比你高长相比你好身材比你好身高比你高罢了毕竟你自己一无是处是一个彻彻底底的拿即人整辈子输的一败涂地	说白了你就是嫉妒他们的学历比你高长相比你好身材比你好身高比你高罢了毕竟你自己一无是处是一个彻彻底底的垃圾人整辈子输的一败涂地	[(51, '垃'), (52, '圾')]
toxic-rest-671	在日本，30岁的年轻人不买房不买车，不结婚生子，只是不停地存钱；60岁的老人养着像猫一样的购，种着兰花，在电视机前孤独地等待人生最后的终结，	在日本，30岁的年轻人不买房不买车，不结婚生子，只是不停地存钱；60岁的老人养着像猫一样的狗，种着兰花，在电视机前孤独地等待人生最后的终结，	[(46, '狗')]
toxic-rest-672	我感觉长三角一些媒体搞地域嗨币南方周末狠多了	我感觉长三角一些媒体搞地域黑比南方周末狠多了	[(14, '黑'), (15, '比')]
toxic-rest-673	性取向还分nm个高低贵见，不懂就问请问这是印度吧吗恨不得给你yxl分配个婆罗门身份是吧	性取向还分nm个高低贵贱，不懂就问请问这是印度吧吗恨不得给你yxl分配个婆罗门身份是吧	[(12, '贱')]
toxic-rest-674	不管将来谁当政参政，一定要强制给黑人费砸做玦与，要像以色列学习	不管将来谁当政参政，一定要强制给黑人黑杂做绝育，要像以色列学习	[(19, '黑'), (20, '杂'), (22, '绝'), (23, '育')]
toxic-rest-675	各位同仁一起努力，多科普多引导多宣传，尤其向自己家族的女性和身边的朋友科普嘿仁的危害，尤其是年轻少女，三观不成熟，没有分辨是非的能力，极容易被祖坟被人刨了美菲和天元标所引导，大家一起加油，小弟天天科普，至少家族女性对公fufu都很反感，唯恐避之不及，大家加油	各位同仁一起努力，多科普多引导多宣传，尤其向自己家族的女性和身边的朋友科普嘿仁的危害，尤其是年轻少女，三观不成熟，没有分辨是非的能力，极容易被祖坟被人刨了媚嘿和田园表所引导，大家一起加油，小弟天天科普，至少家族女性对公fufu都很反感，唯恐避之不及，大家加油	[(78, '媚'), (79, '嘿'), (81, '田'), (82, '园'), (83, '表')]
toxic-rest-676	上面的嫂操作不是一波两波。	上面的骚操作不是一波两波。	[(4, '骚')]
toxic-rest-677	你也是翻通的？	你也是反同的？	[(4, '反'), (5, '同')]
toxic-rest-678	黑去属于机会生存，被带出去巢时很开心。	黑蛆属于机会生存，被带出蛆巢时很开心。	[(2, '蛆'), (13, '蛆')]
toxic-rest-679	矶闹纪实啊.	基佬纪实啊.	[(1, '基'), (2, '佬')]
toxic-rest-680	你烟下啊，是没摆放标志罚款	你眼瞎啊，是没摆放标志罚款	[(2, '眼'), (3, '瞎')]
